DEBUG: default set up.

DEBUG:  good luck setup.
yourself starts in the Your Bedroom.
salt shaker starts in the Your Bedroom.
lucky boxers starts in the Laundry Room.
dog bed starts in the Living Room.
Dad starts in the Parent's Bedroom.
step stool starts in the Bobby's Bedroom.
your bed starts in the Your Bedroom.
dresser starts in the Your Bedroom.
hamper starts in the Laundry Room.
Teddy starts in the Garage.
Mom starts in the Entry Hall.
chaser starts in the Entry Hall.
rubber ball starts in the Living Room.
Bobby starts in the Bobby's Bedroom.
light switch starts in the Your Bedroom.
drawers starts in the Your Bedroom.
small mirror starts in the Shared Bathroom.
cabinet starts in the Shared Bathroom.
toybox starts in the Bobby's Bedroom.
front door starts in the Entry Hall.
hall closet starts in the Small Hall.
vacuum cleaner starts in the Small Hall.
queen-sized bed starts in the Parent's Bedroom.
nightstand starts in the Parent's Bedroom.
large mirror starts in the Parent's Bathroom.
pantry starts in the Kitchen.
table starts in the Dining Room.
high chair starts in the Bobby's Bedroom.
washer starts in the Laundry Room.
dryer starts in the Laundry Room.
car starts in the Garage.
garage door starts in the Garage.
toolbox starts in the Garage.
floor starts in the Your Bedroom.
washer starts in the Laundry Room.
dryer starts in the Laundry Room.

Bad Teddy
An Interactive Fiction by "Y'Gael of Atrii" this is a subtitle
Release 1 / Serial number 210115 / Inform 7 build 6M62 (I6/v6.33 lib 6/12N) SD

Your Bedroom
This is your bedroom. There is a shelf with nothing on it.

You can see your bed and a dresser here.

>take ball
Taken.

>take apple
Taken.

* * *

>take ball
Taken.

>i
You are carrying:
  a ball

>ACTIONS
Actions listing on.

>DROP BALL
[dropping the ball]
Dropped.
[dropping the ball - succeeded]

>TAKE BALL
[taking the ball]
Taken.
[taking the ball - succeeded]

* * *

>take apple
Taken.

>i
You are carrying:
  an apple

>drop apple
Dropped.

>take ball
Taken.

* * *

>take teddy
Taken.

teddy is in the Your Bedroom

>drop teddy
Dropped.

>get on stool
You get onto the kiddie stool.

>turn on lights
"Click." The lights go on.

My Bedroom (on the kiddie stool)
This is my bedroom. There is a shelf with  a teddy bear on it. 

You can see a salt here.

>s
(first getting off the kiddie stool)

Shared Bathroom
I share this bathroom with my brother, Bobby.

You can see a mirror here.

>wait
Time passes.

>wait
Time passes.

>i
You are carrying nothing.

>i
You are carrying:
  Teddy

"Click." The lights go off.

It is now pitch dark in here!

>turn on lights
You're too small to reach it.

    *** Teddy got you. ***

Would you like to RESTART, RESTORE a saved game, QUIT or UNDO the last command?

* * *

>take teddy
Taken.

teddy is in the Your Bedroom

>l
My Bedroom
You can see Mom, Teddy and a salt here.

>take salt
You can't see any such thing.

* * *

>take teddy
Taken.

teddy is in the Your Bedroom

>wait
Time passes.

yourself

>wait
Time passes.

"Click." The lights go off.

It is now pitch dark in here!

>wait
Time passes.

* * *

>take salt
You can't see any such thing.

>get on stool
You get onto the kiddie stool.

* * *

>turn on lights
"Click." The lights go on.

My Bedroom (on the kiddie stool)
This is my bedroom. There is a shelf with  a teddy bear on it. 

You can see a salt here.

>take salt
Taken.

* * *

>wait
Time passes.

"Click." The lights go off.

It is now pitch dark in here!

>i
You are carrying:
  Teddy

>drop teddy
Dropped.

    *** Teddy got you. ***

Would you like to RESTART, RESTORE a saved game, QUIT or UNDO the last command?

>s
Please give one of the answers above.

Would you like to RESTART, RESTORE a saved game, QUIT or UNDO the last command?

>restart
Bad Teddy
An Interactive Fiction by "Y'Gael of Atrii" this is a subtitle
Release 1 / Serial number 201215 / Inform 7 build 6M62 (I6/v6.33 lib 6/12N) SD

My Bedroom
This is my bedroom. There is a shelf with  a teddy bear on it. 

You can see Mom, a kiddie stool and a salt here.

>s
Shared Bathroom
I share this bathroom with my brother, Bobby.

You can see a mirror here.

>wait
Time passes.

>i
You are carrying:
  Teddy

>look in mirror
I can see myself in it.
"Click." The lights go off.

It is now pitch dark in here!

>wait
Time passes.

>wait
Time passes.

    *** Teddy got you. ***

Would you like to RESTART, RESTORE a saved game, QUIT or UNDO the last command?

* * *

>wait
Time passes.

yourself

>s
Shared Bathroom
I share this bathroom with my brother, Bobby.

You can see a mirror here.

yourself

>e
Bobby's Bedroom
You can see a toybox (closed) here.

yourself

>e
You can't go that way.

yourself

>s
You can't go that way.

yourself

>w
Shared Bathroom
I share this bathroom with my brother, Bobby.

You can see a mirror here.

yourselfactyou alonelitcarried
[** Programming error: tried to find the "parent" of nothing **]
"Click." 
The lights go off.

It is now pitch dark in here!

* * *

>take teddy
Taken.

teddy is in the Your Bedroom

>get on stool
You get onto the kiddie stool.

yourself

>drop teddy
Dropped

>l
My Bedroom (on the kiddie stool)
This is my bedroom. There is a shelf with  a teddy bear on it. 

You can see Mom and a salt here.

* * *

>get on stool
You get onto the kiddie stool.

yourself

>wait
Time passes.

yourselfactyou alonelitcarried"Click." 
The lights go off.

It is now pitch dark in here!

* * *

>take teddy
Taken.

teddy is in the Your Bedroom

>s
Shared Bathroom
I share this bathroom with my brother, Bobby.

You can see a mirror here.

yourselfactyou alonelitcarried"Click." 
The lights go off.

It is now pitch dark in here!

>drop teddy
Dropped.

>n
My Bedroom
This is my bedroom. There is a shelf with nothing on it.

You can see Mom, a kiddie stool and a salt here.

>l
My Bedroom
This is my bedroom. There is a shelf with  a teddy bear on it. 

You can see Mom, a kiddie stool and a salt here.

>wait
Time passes.

>wait
Time passes.

"Click." The lights go off.

It is now pitch dark in here!

* * *

>i
You are carrying:
  Teddy

>get on stool
You get onto the kiddie stool.

>turn on lights
"Click." The lights go on.

My Bedroom (on the kiddie stool)
This is my bedroom. There is a shelf with nothing on it.

You can see Mom and a salt here.

>wait
Time passes.

>l
My Bedroom (on the kiddie stool)
This is my bedroom. There is a shelf with nothing on it.

You can see Mom and a salt here.

>i
You are carrying:
  Teddy

>wait
Time passes.

* * *

>l
My Bedroom (on the kiddie stool)
This is my bedroom. There is a shelf with nothing on it.

You can see Mom and a salt here.

>wait
Time passes.

* * *

>i
You are carrying:
  Teddy

>i
You are carrying:
  Teddy

* * *

>s
Shared Bathroom
I share this bathroom with my brother, Bobby.

You can see a mirror here.

yourselfactyou alonelitcarried"Click." 
The lights go off.

It is now pitch dark in here!

>e
Bobby's Bedroom
You can see Mom and a toybox (closed) here.

yourself and Mom

>e
You can't go that way.

yourselfactyou alonelitcarried"Click." The lights go on.

It is now pitch dark in here!

>n
Small Hall
yourself

>e
Living Room
yourself

>s
Entry Hall
yourself

>s
You can't go that way.

yourself

>e
You can't go that way.

yourselfactyou alonelitcarried"Click." The lights go on.

It is now pitch dark in here!

>s
You can't go that way.

yourself

>n
Living Room
yourselfactyou alonelitcarried"Click." The lights go on.

It is now pitch dark in here!

>n
Kitchen
yourselfactyou alonelitcarried"Click." The lights go on.

It is now pitch dark in here!

>e
Dining Room
yourself

>w
Darkness
It is pitch dark, and you can't see a thing.

yourself

>s
Darkness
It is pitch dark, and you can't see a thing.

yourself

>s
Darkness
It is pitch dark, and you can't see a thing.

yourself

>e
You can't go that way.

yourself

>w
You can't go that way.

yourself

>w
You can't go that way.

yourselfactyou alonedarkcarried

    *** Teddy got you. ***

Would you like to RESTART, RESTORE a saved game, QUIT or UNDO the last command?

* * *

>e
Bobby's Bedroom
You can see Mom and a toybox (closed) here.

yourself and Mom

>s
You can't go that way.

yourself and Mom

>w
Shared Bathroom
I share this bathroom with my brother, Bobby.

You can see a mirror here.

yourself

>wait
Time passes.

yourselfactyou alonelitcarried
[** Programming error: tried to find the "parent" of nothing **]
"Click." 
The lights go off.

It is now pitch dark in here!

* * *

>s
Shared Bathroom
I share this bathroom with my brother, Bobby.

You can see a mirror here.

yourselfactyou alonelitcarried"Click." 
The lights go off.

It is now pitch dark in here!

>wait
Time passes.

yourself

>wait
Time passes.

yourself

>it
That's not a verb I recognise.

>wait
Time passes.

yourself

>wait
Time passes.

yourselfactyou alonelitcarried
[** Programming error: tried to find the "parent" of nothing **]

It is now pitch dark in here!

* * *

>s
Shared Bathroom
I share this bathroom with my brother, Bobby.

You can see a mirror here.

yourselfactyou alonelitcarried"Click." 
The lights go off.

It is now pitch dark in here!

>n
My Bedroom
This is my bedroom. There is a shelf with nothing on it.

You can see a kiddie stool here.

yourself

>get on stool
You get onto the kiddie stool.

yourself

>wait
Time passes.

yourself

>wait
Time passes.

yourselfactyou alonelitcarried
It is now pitch dark in here!

>drop teddy
Dropped.

yourself

>turn on lights
"Click." 
The lights go on.

yourself
My Bedroom (on the kiddie stool)
This is my bedroom. There is a shelf with  a teddy bear on it.

>wait
Time passes.

yourselfactyou alonelitnot carried

* * *

>take teddy
Taken.

teddy is in the Your Bedroom

>e
Small Hall
You can see a hall closet (closed) here.

"Click." 
The lights go off.
teddy is in the Small Hall
It is now pitch dark in here!

>e
Living Room
"Click." 
The lights go off.
teddy is in the Living Room
It is now pitch dark in here!

>e
Laundry Room
You can see a washer (closed) and a dryer (closed) here.

teddy is in the Laundry Room

>e
You can't go that way.

yourself

>undo
Darkness
[Previous turn undone.]

>undo
Darkness
[Previous turn undone.]

>undo
Small Hall
[Previous turn undone.]

>e
Living Room
yourself

>e
Laundry Room
You can see a dryer (closed) here.

yourself

>open dryer
You open the dryer.

yourself

>put teddy in dryer
You put Teddy into the dryer.

yourself

>close dryer
You close the dryer.

yourselfactescaped closed

>examine dryer
The dryer is empty.

yourself

>take teddy
Taken.

yourself

>put teddy in dryer
You put Teddy into the dryer.

yourself

>close dryer
You close the dryer.

yourself

>wait
Time passes.

yourself

>wait
Time passes.

yourselfacttrappedstill.

>wait
Time passes.

yourselfacttrappedstill.

>wait
Time passes.

yourself

>i
You are carrying nothing.

yourselfacttrappedstill.

>wait
Time passes.

yourself

>wait
Time passes.

yourselfactescaped closed

* * *

>e
Laundry Room
You can see a washer (closed) and a dryer (closed) here.

teddy is in the Laundry Room

>put teddy in drier
You can't see any such thing.

>open dryer
(the dryer)
It isn't something you can open.

teddy is in the Laundry Room

* * *

>e
Laundry Room
You can see a washer (closed) and a dryer (closed) here.

teddy is in the Laundry Room

>put teddy in dryer door
The dryer door is closed.

teddy is in the Laundry Room

>open dryer door
You open the dryer door.

teddy is in the Laundry Room

>put teddy in dryer door
You put Teddy into the dryer door.

teddy is in the Laundry Room

>ACTIONS
Actions listing on.

>TAKE TEDDY OUT OF DYER DOOR
I only understood you as far as wanting to take Teddy.

>TAKE TEDDY
[taking Teddy]
Taken.
[taking Teddy - succeeded]

teddy is in the Laundry Room

>put teddy in dryer
(the dryer)
[inserting Teddy into the dryer]
That can't contain things.
[inserting Teddy into the dryer - failed the can't insert into what's not a container rule]

teddy is in the Laundry Room

>turn on dryer
(the dryer)
[switching on the dryer]
increase : 1[switching on the dryer - succeeded]

teddy is in the Laundry Room

* * *

>e
Laundry Room
You can see a washer (closed) and a dryer (closed) here.

teddy is in the Laundry Room

>open dyer
You can't see any such thing.

>open dryer
(the dryer)
You open the dryer door.

teddy is in the Laundry Room

>put teddy in dryer
(the dryer)
teddy is in the Laundry Room

>l
Laundry Room
You can see a dryer and a washer here.

teddy is in the Laundry Room

>examine dryer
(the dryer)
The dryer is currently switched off.

teddy is in the Laundry Room

>examine dryer door
The dryer door is empty.

teddy is in the Laundry Room

* * *

>e
Laundry Room
You can see a washer (closed) and a dryer (closed) here.

teddy is in the Laundry Room

>open washer
You open the washer.

teddy is in the Laundry Room

>put teddy in washer
You put Teddy into the washer.

teddy is in the Laundry Room

>close washer
You close the washer.

teddy is in the Laundry Room

>turn on washer
You turn the washer on
You hear the sloshing of the washer.

teddy is in nothing

>i
You are carrying:
  Teddy
  a salt shaker

You hear the sloshing of the washer.

teddy is in the Laundry Room

>put teddy in washer
The washer is closed.

You hear the sloshing of the washer.

"Click." 
The lights go off.
teddy is in the Laundry Room
It is now pitch dark in here!

>undo
Laundry Room
[Previous turn undone.]

>open washer
the washer is running. You must wait until the cycle is complete.

You hear the sloshing of the washer.

teddy is in the Laundry Room

>put teddy in washer
The washer is closed.

You hear the sloshing of the washer.

teddy is in the Laundry Room

>open washer
the washer is running. You must wait until the cycle is complete.

You hear the sloshing of the washer.

teddy is in the Laundry Room

>open drier
You can't see any such thing.

>open dryer
You open the dryer.

You hear the sloshing of the washer.

teddy is in the Laundry Room

>put teddy in dryer
You put Teddy into the dryer.

You hear the sloshing of the washer.

teddy is in the Laundry Room

>close dryer
You close the dryer.

You hear the sloshing of the washer.

teddy is in the Laundry Room

>turn on tryer
You can't see any such thing.

>turn on dryer
You hear the whirring of the dryer.

You hear the sloshing of the washer.

teddy is in the Laundry Room

>i
You are carrying:
  a salt shaker

You hear the whirring of the dryer.

You hear the sloshing of the washer.

teddy is in the Laundry Room

* * *

>i
You are carrying:
  Teddy
  a salt shaker

You hear the sloshing of the washer.

teddy is in the Laundry Room

>put teddy in dryer
The dryer is closed.

You hear the sloshing of the washer.

teddy is in the Laundry Room

>open dryer
You open the dryer.

You hear the sloshing of the washer.

teddy is in the Laundry Room

* * *

>close dryer
You close the dryer.

You hear the sloshing of the washer.

teddy is in the Laundry Room

>turn on dryer
You hear the whirring of the dryer.

You hear the sloshing of the washer.

teddy is in the Laundry Room

>i
You are carrying:
  Teddy

You hear the whirring of the dryer.

You hear the sloshing of the washer.

teddy is in the Laundry Room

>undo
Laundry Room
[Previous turn undone.]

>undo
Laundry Room
[Previous turn undone.]

>i
You are carrying:
  Teddy

You hear the sloshing of the washer.

"Click." 
The lights go off.
teddy is in the Laundry Room
It is now pitch dark in here!

>undo
Laundry Room
[Previous turn undone.]

* * *

>open washer
the washer is running. You must wait until the cycle is complete.

You hear the sloshing of the washer.

teddy is in the Laundry Room

>open dryer
You open the dryer.

You hear the sloshing of the washer.

teddy is in the Laundry Room

* * *

>turn on dryer
You hear the whirring of the dryer.

You hear the sloshing of the washer.

teddy is in the Laundry Room

>i
You are carrying:
  Teddy

You hear the whirring of the dryer.

teddy is in the Laundry Room

>undo
Laundry Room
[Previous turn undone.]

>udno
That's not a verb I recognise.

>undo
Laundry Room
[Previous turn undone.]

>i
You are carrying:
  Teddy

You hear the whirring of the dryer.

teddy is in the Laundry Room

* * *

>undo
Laundry Room
[Previous turn undone.]

>i
You are carrying:
  Teddy

You hear the sloshing of the washer.

teddy is in the Laundry Room

>put teddy in dryer
The dryer is closed.

teddy is in the Laundry Room

>open dryer
You open the dryer.

teddy is in the Laundry Room

>put teddy in dryer
You put Teddy into the dryer.

teddy is in the Laundry Room

>close dryer
You close the dryer.

teddy is in the Laundry Room

>turn on dryer
You hear the whirring of the dryer.

teddy is in the Laundry Room

>i
You are carrying:
  Teddy

You hear the whirring of the dryer.

teddy is in the Laundry Room

* * *

>i
You are carrying:
  Teddy
  a salt shaker

You hear the sloshing of the washer.

teddy is in the Laundry Room

>wait
Time passes.

teddy is in nothing

>i
You are carrying:
  a salt shaker

teddy is in nothing

>i
You are carrying:
  a salt shaker

teddy is in nothing

* * *

>i
You are carrying:
  Teddy
  a salt shaker

You hear the sloshing of the washer.

teddy is in the Laundry Room

>undo
Laundry Room
[Previous turn undone.]

>put teddy in washer
The washer is closed.

teddy is in the Laundry Room

>open washer
You open the washer.

teddy is in the Laundry Room

* * *

>turn on washer
You turn the washer on
You hear the sloshing of the washer.

teddy is in nothing

>open washer
You must wait until the wash cycle is over.

You hear the sloshing of the washer.

teddy is in nothing

>wait
Time passes.

You hear the sloshing of the washer.

teddy is in nothing

>wait
Time passes.

You hear the sloshing of the washer.

teddy is in nothing

>i
You are carrying:
  a salt shaker

You hear the sloshing of the washer.

teddy is in nothing

>i
You are carrying:
  a salt shaker

You hear the sloshing of the washer.

teddy is in nothing

>i
You are carrying:
  a salt shaker

You hear the sloshing of the washer.

teddy is in nothing
"BANG!"
You hear the sound of something breaking.

>wait
Time passes.

You hear the sloshing of the washer.

teddy is in the Laundry Room

* * *

>turn on washer
You turn the washer on
You hear the sloshing of the washer.

teddy is in nothing

>e
You can't go that way.

You hear the sloshing of the washer.

teddy is in nothing

>w
Darkness
It is pitch dark, and you can't see a thing.

You hear the distant sloshing of the washer.

teddy is in nothing

>e
Laundry Room
You can see a washer (closed) and a dryer (closed) here.

You hear the sloshing of the washer.

teddy is in nothing

>wait
Time passes.

You hear the sloshing of the washer.

teddy is in nothing

>i
You are carrying:
  a lucky boxers
  a salt shaker

You hear the sloshing of the washer.

teddy is in nothing

>i
You are carrying:
  a lucky boxers
  a salt shaker

You hear the sloshing of the washer.

teddy is in nothing

>i
You are carrying:
  a lucky boxers
  a salt shaker

You hear the sloshing of the washer.

teddy is in nothing
"BANG!"
You hear the sound of something breaking.

>open washer
You open the washer.

teddy is in the Laundry Room

>close washer
You close the washer.

teddy is in the Laundry Room

>turn on washer
It's broken.

teddy is in the Laundry Room

>take teddy
Taken.

teddy is in the Laundry Room

>open dryer
You open the dryer.

teddy is in the Laundry Room

>put tedy in dryer
You can't see any such thing.

>put teddy in dryer
You put Teddy into the dryer.

teddy is in the Laundry Room

>put boxers in dryer
You put the lucky boxers into the dryer.

teddy is in the Laundry Room

>close ryer
You can't see any such thing.

>close dryer
You close the dryer.

teddy is in the Laundry Room

>i
You are carrying:
  a salt shaker

teddy is in the Laundry Room

>turn on dryer
You turn the dryer on
You hear the whirring of the dryer.

teddy is in the Laundry Room

>i
You are carrying:
  Teddy
  a salt shaker

You hear the whirring of the dryer.

teddy is in the Laundry Room

>undo
Laundry Room
[Previous turn undone.]

>i
You are carrying:
  Teddy
  a salt shaker

teddy is in the Laundry Room

>undo
Laundry Room
[Previous turn undone.]

>put teddy in dryer
You can't see any such thing.

>i
You are carrying:
  a salt shaker

teddy is in the Laundry Room

>take teddy
You can't see any such thing.

>l
Laundry Room
You can see a washer (closed) and a dryer (closed) here.

teddy is in the Laundry Room

>take teddy
You already have that.

"Click." 
The lights go off.
teddy is in the Laundry Room
It is now pitch dark in here!

>undo
Laundry Room
[Previous turn undone.]

>put teddy in dryer
The dryer is closed.

teddy is in the Laundry Room

>open dryer
You open the dryer, revealing a lucky boxers.

"Click." 
The lights go off.
teddy is in the Laundry Room
It is now pitch dark in here!

>undo
Laundry Room
[Previous turn undone.]

>upen dryer
That's not a verb I recognise.

>open dryer
You open the dryer, revealing a lucky boxers.

teddy is in the Laundry Room

>put teddy in dryer
You put Teddy into the dryer.

teddy is in the Laundry Room

* * *

>close dryer
You close the dryer.

teddy is in the Laundry Room

>turn on dryer
You turn the dryer on
You hear the whirring of the dryer.

teddy is in nothing

* * *

>put teddy in washer
You put Teddy into the washer.

teddy is in the Laundry Room

>look in washer
In the washer is fake teddy.

teddy is in nothing

>close washer
You close the washer.

teddy is in nothing

>turn on washer
You hear the sloshing of the washer.

teddy is in nothing

>wait
Time passes.

You hear the sloshing of the washer.

teddy is in the Laundry Room

>take teddy
Taken.

You hear the sloshing of the washer.

"Click." 
The lights go off.
teddy is in the Laundry Room
It is now pitch dark in here!

* * *

>take teddy
Taken.

teddy is in the Your Bedroom

>put teddy on stool
yourself

>l
My Bedroom
This is my bedroom. There is a shelf with  a teddy bear on it. 

You can see a kiddie stool here.

yourself

* * *

>take teddy
Taken.

teddy is in the Your Bedroom

>w
You can't go that way.

"Click." 
The lights go off.

It is now pitch dark in here!

>e
Small Hall
You can see a hall closet (closed) here.

"Click." 
The lights go off.

It is now pitch dark in here!

>e
Living Room

>e
Laundry Room
You can see a dryer (closed) and a washer (closed) here.

>put teddy in dryer
The dryer is closed.

>open dryer
You open the dryer.

"Click." 
The lights go off.

It is now pitch dark in here!

>undo
Laundry Room
[Previous turn undone.]

>open dryer
You open the dryer.

"Click." 
The lights go off.

It is now pitch dark in here!

* * *

>undo
Laundry Room
[Previous turn undone.]

>OPEN DRYER
You open the dryer.

>put teddy in dryer
You put Teddy into the dryer.

* * *

>l
Laundry Room
You can see a dryer (closed) and a washer (closed) here.

>open dryer
You open the dryer.

>l
Laundry Room
You can see a dryer (empty) and a washer (closed) here.

>take teddy
You can't see any such thing.

>wait
Time passes.

>l
Laundry Room
You can see a dryer (empty) and a washer (closed) here.

>l
Laundry Room
You can see a dryer (empty) and a washer (closed) here.

* * *

>take teddy
You can't see any such thing.

>take teddy
You can't see any such thing.

* * *

>take teddy
Taken.

teddy is in the Your Bedroom

>poue
That's not a verb I recognise.

>e
Small Hall
You can see Mom and a hall closet (closed) here.

mom is light-policing 
mom is locating salt 

Mom goes west.

teddy is in the Small Hall

>open closet
You open the hall closet, revealing a vacuum cleaner.

mom is light-policing 
mom is locating salt 

Mom arrives from the west.

teddy is in the Small Hall

>take vacuum
Taken.

mom is light-policing 
mom is locating salt 

teddy is in the Small Hall

>pour salt on ground
You pour some salt on the floor
the Small Hall is salted.

mom is light-policing 
mom is locating salt 
mom sees the salt in Small Hall
mom is vacuum-fetching
mom is fetching the vacuum 

Mom: Where is the vacuum cleaner?
mom is vacuum-seeking. 

Mom closes the hall closet.

teddy is in the Small Hall

>wait
Time passes.

mom is light-policing 
mom is locating salt 
mom sees the salt in Small Hall
mom is vacuum-seeking
You took my vacuum cleaner!
Mom takes the vacuum from you and puts you in time-out
Bedroom
mom is vacuum-doing

teddy is in the Bedroom

>i
You are carrying:
  Teddy
  a lucky boxers
  a salt shaker

mom is light-policing 
mom is locating salt 
mom sees the salt in Small Hall
mom is vacuum-doing
BRRR! You hear the vacuum cleaner
teddy is in the Bedroom

>wait
Time passes.

mom is light-policing 
mom is locating salt 
mom is returning the vacuum

teddy is in the Bedroom

>wait
Time passes.

mom is light-policing 
mom is locating salt 

teddy is in the Bedroom

>wait
Time passes.

mom is light-policing 
mom is locating salt 

teddy is in the Bedroom

>wait
Time passes.

mom is light-policing 
mom is locating salt 

"Click." 
The lights go off.

teddy is in the Bedroom
It is now pitch dark in here!

>undo
Bedroom
[Previous turn undone.]

>wait
Time passes.

mom is light-policing 
mom is locating salt 

teddy is in the Bedroom

>s
You can't go that way.

mom is light-policing 
mom is locating salt 

teddy is in the Bedroom

>wait
Time passes.

mom is light-policing 
mom is locating salt 

teddy is in the Bedroom
Your Bedroom
This is your bedroom. There is a shelf withnothing on it.

You can see a kiddie stool, your bed and a dresser here.

time out is over

>i
You are carrying:
  Teddy
  a lucky boxers
  a salt shaker

mom is light-policing 
mom is locating salt 
"Click." 
The lights go off.

teddy is in the Your Bedroom
It is now pitch dark in here!

* * *

>take teddy
Taken.

teddy is in the Your Bedroom

>pour salt on teddy
You pour some salt on Teddy.

Teddy shrieks and bites into your arm with a dozen needle-sharp teeth. You drop the bear and the salt shaker, spilling the remainder of its contents. When you look up from your wound, you notice that Teddy is nowhere to be seen.
DEBUG: Teddy heard you
Mom seems to be oblivious to your struggle.

teddy is in the Dining Room

>examine salt shaker
It is empty.

teddy is in the Dining Room

>wait
Time passes.

mom is light-policing 
mom is locating salt 
mom sees the salt in Your Bedroom
mom is vacuum-fetching
mom is fetching the vacuum 

Mom goes east.

teddy is in the Dining Room

* * *

>turn on light swtich
It isn't something you can switch.

* * *

>turn on switch
You can't see any such thing.

>turn off light switch
You can't see any such thing.

* * *

>hi mom
That's not a verb I recognise.

>say hi to mom
There is no reply.

* * *

>turn on lights
You're too small to reach it.

yourself

>turn off lights
"Click."
It is now pitch dark in here!

>l
Darkness
It is pitch dark, and you can't see a thing.

>turn on lights
You can't see any such thing.

* * *

>turn off lights
"Click."
It is now pitch dark in here!

>turn on lights
"Click."
My Bedroom
This is my bedroom. There is a shelf with  a teddy bear on it. 

You can see Mom and a salt here.

>s
Shared Bathroom

>n
My Bedroom
This is my bedroom. There is a shelf with  a teddy bear on it. 

You can see Mom and a salt here.

"Click."
It is now pitch dark in here!

>turn on lights
"Click."
My Bedroom
This is my bedroom. There is a shelf with  a teddy bear on it. 

You can see Mom and a salt here.

* * *

>turn on lights
You're too small to reach it.

yourself

>get on stool
You get onto the kiddie stool.

yourselfactyou alonelitnot carried

>turn on lights
The lights are already on.

yourself

>turn off lights
"Click." 
The lights go off.

yourself
It is now pitch dark in here!

>turn on lights
"Click." 
The lights go on.

yourself
My Bedroom (on the kiddie stool)
This is my bedroom. There is a shelf with nothing on it.

>drop teddy
Dropped.

yourself

>s
(first getting off the kiddie stool)

Shared Bathroom
I share this bathroom with my brother, Bobby.

You can see a mirror here.

* * *

>wait
Time passes.

>n
My Bedroom
This is my bedroom. There is a shelf with  a teddy bear on it. 

You can see a roomba and a kiddie stool here.

yourself

>wait
Time passes.

yourself

>wait
Time passes.

yourselfactyou alonelitnot carried

>drop teddy
Dropped.

yourself

>wait
Time passes.

yourself

* * *

>wait
Time passes.

yourselfactyou alonelitnot carried

>wait
Time passes.

yourself

* * *

>turn on lights
You're too small to reach it.

yourself

>turn on lights
You can't see any such thing.

>get on stool
You can't see any such thing.

>l
Darkness
It is pitch dark, and you can't see a thing.

>i
You are carrying nothing.

>turn on lights
You can't see any such thing.

* * *

>turn off lights
You're too small to reach it.

teddy is in the Your Bedroom

>turn on lights
You can't see any such thing.

>ACTIONS
Actions listing on.

>turn on lights
You can't see any such thing.

>l
[looking]
Darkness
It is pitch dark, and you can't see a thing.

[looking - succeeded]

* * *

>turn on lights
You can't see any such thing.

>l
Darkness
It is pitch dark, and you can't see a thing.

* * *

>turn off lights
You're too small to reach it.

teddy is in the Your Bedroom

>l
My Bedroom
You can see Mom, Teddy and a salt here.

test

>l
My Bedroom
You can see Mom and Teddy here.

>turn off lights
Click.

>l
My Bedroom
You can see Mom and Teddy here.

* * *

>l
My Bedroom
You can see Mom, Teddy and a salt here.

test

>turn off lights
Click.

>s
That's not a verb I recognise.

>n
That's not a verb I recognise.

>e
That's not a verb I recognise.

>w
That's not a verb I recognise.

* * *

>turn off lights
You're too small to reach it.

teddy is in the Your Bedroom

>get on stool
You get onto the step stool.

mom is light-policing 
mom is locating salt 

Mom goes south.

teddy is in the Your Bedroom

>turn off lights
"Click." 
The lights go off.

mom is light-policing 
mom is locating salt 

teddy is in the Your Bedroom

>s
(first getting off the kiddie stool)

Shared Bathroom

>n
Darkness
It is pitch dark, and you can't see a thing.

* * *

>turn off lights
"Click." 
The lights go off.

mom is light-policing 
mom is locating salt 

teddy is in the Your Bedroom

>turn on lights
The lights are already on.

Mom and yourself

>l
My Bedroom (on the kiddie stool)
This is my bedroom. There is a shelf with nothing on it.

You can see Mom and a salt here.

* * *

>turn off lights
You're too small to reach it.

teddy is in the Your Bedroom

>wait
Time passes.

yourself and Mom

>wait
Time passes.

yourself and Mom

>wair
That's not a verb I recognise.

>i
You are carrying:
  a salt shaker

yourself and Mom

>i
You are carrying:
  a salt shaker

yourself and Mom

>l
Your Bedroom
This is your bedroom. There is a shelf with  a teddy bear on it. 

You can see Mom, a kiddie stool, your bed and a dresser here.

yourself and Momacttwolitnot carriedlightsgoout

>wait
Time passes.

yourself and Momacttwolitnot carried

>l
Your Bedroom
This is your bedroom. There is a shelf with nothing on it.

You can see Mom, a kiddie stool, your bed and a dresser here.

yourself and Mom

>wait
Time passes.

yourself and Mom

>wait
Time passes.

yourself and Momacttwolitcarriedlightsgoout

>wait
Time passes.

yourself and Mom

* * *

>l
Your Bedroom
This is your bedroom. There is a shelf with a teddy bear on it. 

You can see a widget, dad, your bed and a dresser here.

DEBUG: dadvision is empty
DEBUG: dad looking for things
*** Run-time problem P10: Since the floor is not allowed the property "starting position", it is against the rules to try to use it.

DEBUG:adding floor to dadvision
DEBUG: the stating position of floor is nothing

DEBUG:adding light switch to dadvision
DEBUG: the stating position of light switch is nothing

DEBUG:adding yourself to dadvision
DEBUG: the stating position of yourself is nothing

DEBUG:adding widget to dadvision
DEBUG: the stating position of widget is the shared bathroom
Dad picks up the widget.

DEBUG:adding dad to dadvision
DEBUG: the stating position of dad is nothing

DEBUG:adding Teddy to dadvision
DEBUG: the stating position of Teddy is nothing
Dad picks up Teddy.

DEBUG:adding your bed to dadvision
DEBUG: the stating position of your bed is nothing

DEBUG:adding dresser to dadvision
DEBUG: the stating position of dresser is nothing

DEBUG: dad is chasing
DEBUG: Teddy's is deciding
 DEBUG: teddy is in the Your Bedroom

>take teddy
Taken.

>take Teddy
You can't see any such thing.

>take salt
You can't see any such thing.

>l
My Bedroom
You can see Mom, Teddy and a salt here.

>s
That's not a verb I recognise.

>e
That's not a verb I recognise.

* * *

>w
That's not a verb I recognise.

>n
That's not a verb I recognise.

* * *

>take teddy
Taken.

>l
My Bedroom
You can see Mom and a salt here.

>i
You are carrying:
  Teddy

* * *

>take teddy
Taken.

>i
You are carrying:
  Teddy

* * *

>s
Shared Bathroom

>n
My Bedroom
You can see Mom, Teddy and a salt here.

* * *

>i
You are carrying nothing.

"Click."
It is now pitch dark in here!

>take teddy
Taken.

>i
You are carrying:

* * *

>i
You are carrying nothing.

"Click."
It is now pitch dark in here!

>l
My Bedroom
You can see Mom and a salt here.

>take teddy
Taken.

* * *

>i
You are carrying nothing.

"Click."
It is now pitch dark in here!

>i
You are carrying nothing.

>i
You are carrying nothing.

>i
You are carrying:
  Teddy

>i
You are carrying:
  Teddy

    *** Teddy got you. ***

Would you like to RESTART, RESTORE a saved game, QUIT or UNDO the last command?

* * *

>l
Your Bedroom
This is your bedroom. There is a shelf with a teddy bear on it. 

You can see your bed and a dresser here.

DEBUG: dadvision is empty
DEBUG: dad looking for things
DEBUG:adding Chaser to dadvision

DEBUG:adding dad to dadvision

DEBUG:adding mirror to dadvision

DEBUG: dad is chasingmom is light-policing 
mom is locating salt 

DEBUG: Mom wanders to the Living Room
DEBUG: Teddy's is deciding 
DEBUG: teddy acts
 DEBUG: teddy is in the Your Bedroom

>i
You are carrying:
  a salt shaker

* * *

>wait
Time passes.

mom is light-policing 
"Who keeps turning off the lights?"
Exasperated, Mom switches on the lights.
"Click." 
The lights go on.
mom is locating salt 
DEBUG: Mom wanders to the Shared Bathroom
DEBUG: Teddy's turnteddy is in the Your Bedroom

Your Bedroom
This is your bedroom. There is a shelf with nothing on it.

You can see a step stool, your bed, a dresser and a hamper (empty) here.

>l
Your Bedroom
This is your bedroom. There is a shelf with nothing on it.

You can see a step stool, your bed, a dresser and a hamper (empty) here.

DEBUG: Teddy's turn"Click." 
The lights go off.
teddy is in the Your Bedroom

It is now pitch dark in here!

>wait
Time passes.

>l
My Bedroom
This is my bedroom. There is a shelf with  a teddy bear on it. 

You can see Mom and a salt here.

>wait
Time passes.

* * *

>i
You are carrying nothing.

>wait
Time passes.

* * *

>l
My Bedroom
This is my bedroom. There is a shelf with  a teddy bear on it. 

You can see Mom and a salt here.

>i
You are carrying nothing.

* * *

>put salt on stool
You put the salt shaker on the kiddie stool.

mom turnmom is in: the Your Bedroomyourself and Momacttwolitnot carriedmom is in: the Your Bedroom
enclosed

* * *

>pour salt on ground
You pour the salt on the floor.

mom turnmom notices the salt in the Your Bedroom
Mom goes south.

>s
Shared Bathroom
I share this bathroom with my brother, Bobby.

You can see Mom and a mirror here.

mom turn
Mom goes north.

>n
Your Bedroom
This is your bedroom. There is a shelf with nothing on it.

You can see Mom, a kiddie stool, your bed and a dresser here.

mom turnmom notices the salt in the Your Bedroom
Mom goes south.

* * *

>e
Small Hall
You can see a floor and a hall closet (closed) here.

The light switch goes west.

light switch and Mom

>w
Your Bedroom
This is your bedroom. There is a shelf with  a teddy bear on it. 

You can see a light switch, Mom, a kiddie stool, your bed and a dresser here.

The yourself goes south.

yourself and Mom

>s
Shared Bathroom
I share this bathroom with my brother, Bobby.

You can see a yourself and a mirror here.

The floor goes north.

floor and Mom

>i
You are carrying:
  a salt shaker

Mom

>n
Your Bedroom
This is your bedroom. There is a shelf with  a teddy bear on it. 

You can see Mom, a kiddie stool, your bed and a dresser here.

The hall closet arrives from the east.

hall closet, yourself and Mom

* * *

>s
You can't go that way.

DEBUG: Teddy's is deciding
 DEBUG: teddy is in the Your Bedroom

>n
Your Bedroom
This is your bedroom. There is a shelf with a teddy bear on it. 

You can see a hamper (empty), a high chair, dad, a widget, your bed and a dresser here.

DEBUG: Teddy's is deciding
 DEBUG: teddy is in the Your Bedroom

>e
Small Hall
You can see bobby and a hall closet (closed) here.

DEBUG: dadvision is empty
DEBUG: dad looking for things
DEBUG: Teddy's is deciding
 DEBUG: teddy is in the Small Hall

>w
That's not a verb I recognise.

* * *

>e
Small Hall
You can see bobby and a hall closet (closed) here.

DEBUG: dadvision is empty
DEBUG: dad looking for things
DEBUG: Teddy's is deciding
 DEBUG: teddy is in the Small Hall

>s
Bobby's Bedroom
You can see Mom and a toybox (closed) here.

>wait
Time passes.

>l
Bobby's Bedroom
You can see Mom and a toybox (closed) here.

>wait
Time passes.

>l
Bobby's Bedroom
You can see Mom and a toybox (closed) here.

actother numberlitlightsgoout
It is now pitch dark in here!

>wait
Time passes.

>l
Darkness
It is pitch dark, and you can't see a thing.

>n
Small Hall
You can see a hall closet (closed) here.

>wait
Time passes.

* * *

>e
Small Hall
You can see bobby and a hall closet (closed) here.

DEBUG: dadvision is empty
DEBUG: dad looking for things
DEBUG: Teddy's is deciding
 DEBUG: teddy is in the Small Hall

>e
Living Room

DEBUG: dadvision is empty
DEBUG: dad looking for thingsDEBUG: Chaser is wandering to the Bobby's Bedroom
DEBUG: Teddy's is deciding
 DEBUG: teddy is in the Living Room

>e
Laundry Room
You can see a dryer (closed) and a washer (closed) here.

turnno vacuume timeBobby

>s
Garage
turnno vacuume timeBobby

>n
Laundry Room
You can see a dryer (closed) and a washer (closed) here.

turnno vacuume time
mom wandersBobby

>w
Living Room
turnno vacuume timeBobby

>w
Small Hall
You can see a hall closet (closed) here.

turnno vacuume timeBobby

>n
Parent's Bedroom
turnno vacuume timeBobby

>w
Parent's Bathroom
turnno vacuume time
mom wandersBobby

>e
Parent's Bedroom
turnno vacuume timeBobbyactother alonelitlightsgoout

>s
Small Hall
You can see a hall closet (closed) here.

turnno vacuume timeBobbyactother alonelitlightsgoout

>s
Bobby's Bedroom
You can see a toybox (closed) here.

turnno vacuume timeBobby

>w
Shared Bathroom
I share this bathroom with my brother, Bobby.

You can see a mirror here.

turnno vacuume timeBobby

>e
Bobby's Bedroom
You can see a toybox (closed) here.

turnno vacuume time
mom wandersBobby

>open toybox
You open the toybox.

turnno vacuume timeBobby

>l
Bobby's Bedroom
You can see a toybox (empty) here.

turnno vacuume timeBobby

* * *

>e
Living Room

DEBUG: dadvision is empty
DEBUG: dad looking for thingsDEBUG: Chaser is wandering to the Bobby's Bedroom
DEBUG: Teddy's is deciding
 DEBUG: teddy is in the Living Room

>s
Entry Hall
You can see Mom, a high chair and a front door here.

DEBUG: dadvision is empty
DEBUG: dad looking for things
DEBUG: Teddy's is deciding
 DEBUG: teddy is in the Entry Hall

>push chair n
Pushing the high chair is difficult and noisy. Time passes.

You push the high chair north to the Living Room.

DEBUG: Teddy heard you
Living Room

DEBUG: dadvision is empty
DEBUG: dad looking for thingsmom is light-policing 
mom is locating salt 

DEBUG: Mom wanders to the Bobby's Bedroom
DEBUG: Teddy's is deciding
 DEBUG: teddy is in the Living Room

>push chair w
Pushing the high chair is difficult and noisy. Time passes.

You push the high chair west to the Small Hall.

DEBUG: Teddy heard you
Small Hall
You can see bobby and a hall closet (closed) here.

DEBUG: dadvision is empty
DEBUG: dad looking for thingsmom is light-policing 
mom is locating salt 

DEBUG: Mom wanders to the shared bathroom
DEBUG: Teddy's is deciding
 DEBUG: teddy is in the Small Hall

>push chair w
Pushing the high chair is difficult and noisy. Time passes.

You push the high chair west to the Your Bedroom.

DEBUG: Teddy heard you
Your Bedroom
This is your bedroom. There is a shelf with nothing on it.

You can see dad, a widget, your bed and a dresser here.

DEBUG: dadvision is empty
DEBUG: dad looking for things
DEBUG:adding high chair to dadvision
DEBUG: the stating position of high chair is the Entry Hall
Dad goes south.

DEBUG: dad is chasing to put away high chairmom is light-policing 
mom is locating salt 

DEBUG: Mom wanders to the Bobby's Bedroom
DEBUG: Teddy's is deciding
 DEBUG: teddy is in the Your Bedroom

* * *

>l
Darkness
It is pitch dark, and you can't see a thing.

>turn on lights
Click.

My Bedroom
You can see Mom, Teddy and a salt here.

* * *

>s
Shared Bathroom

>n
My Bedroom
This is my bedroom. There is a shelf with  a teddy bear on it. 

You can see Mom and a salt here.

* * *

>l
My Bedroom
This is my bedroom. There is a shelf with  a teddy bear on it. 

You can see Mom and a salt here.

* * *

>n
Your Bedroom
This is your bedroom. There is a shelf with a teddy bear on it. 

You can see a hamper (empty), a high chair, dad, a widget, your bed and a dresser here.

DEBUG: Teddy's is deciding
 DEBUG: teddy is in the Your Bedroom

>wait
Time passes.

yourself and Momacttwolitnot carried

>wait
Time passes.

* * *

>wait
Time passes.

yourself and Momacttwolitnot carried

>i
You are carrying:
  Teddy

yourself and Mom

>drop teddy
Dropped.

yourself and Mom

>wait
Time passes.

yourself and Mom

>wait
Time passes.

yourself and Momacttwolitnot carried

>drop teddy
Dropped.

yourself and Mom

* * *

>wait
Time passes.

yourself and Mom

>wait
Time passes.

yourself and Momacttwolitnot carried"Click." 
The lights go off.
lightsgoout"Click." 
The lights go on.
Mom: Who keeps turning off the lights?
Exasperated, Mom switches on the lights.
"Click"

* * *

>n
Your Bedroom
This is your bedroom. There is a shelf with a teddy bear on it. 

You can see a hamper (empty), a high chair, dad, a widget, your bed and a dresser here.

DEBUG: Teddy's is deciding
 DEBUG: teddy is in the Your Bedroom

>s
shared bathroom
I share this bathroom with my brother, Bobby.

You can see Chaser and a mirror here.

DEBUG: Chaser is wandering to the Bobby's Bedroommom is light-policing 
mom is locating salt 

DEBUG: Mom wanders to the Parent's Bedroom
DEBUG: Teddy's is deciding
 DEBUG: teddy is in the Your Bedroom

>wait
Time passes.

Teddy arrives from the north.

* * *

>s
shared bathroom
I share this bathroom with my brother, Bobby.

You can see Chaser and a mirror here.

DEBUG: Chaser is wandering to the Bobby's Bedroommom is light-policing 
mom is locating salt 

DEBUG: Mom wanders to the Parent's Bedroom
DEBUG: Teddy's is deciding
 DEBUG: teddy is in the Your Bedroom

>i
You are carrying:
  a salt shaker

>n
Your Bedroom
This is your bedroom. There is a shelf with a teddy bear on it. 

You can see a hamper (empty), a high chair, dad, a widget, your bed and a dresser here.

DEBUG: dadvision is empty
DEBUG: dad looking for things
Dad goes east.

DEBUG: dad wanders to the Small Hall
DEBUG: Teddy's is deciding
 DEBUG: teddy is in the Your Bedroom

>s
shared bathroom
I share this bathroom with my brother, Bobby.

You can see a mirror here.

DEBUG: dadvision is empty
DEBUG: dad looking for things
DEBUG: dad wanders to the Living Room
DEBUG: Teddy's is deciding 
DEBUG: teddy acts
 DEBUG: teddy is in the Your Bedroom

>e
Bobby's Bedroom
You can see Chaser and a toybox (closed) here.

DEBUG: dadvision is empty
DEBUG: dad looking for things
DEBUG: dad wanders to the Small Hall
DEBUG: Teddy's is deciding
 DEBUG: teddy is in the Your Bedroom

>take ball
That seems to belong to Chaser.

DEBUG: Teddy's is deciding 
DEBUG: teddy acts
DEBUG: Teddy wanders to the Small Hall
 DEBUG: teddy is in the Small Hall

* * *

>n
Your Bedroom
This is your bedroom. There is a shelf with a teddy bear on it. 

You can see a hamper (empty), a high chair, dad, a widget, your bed and a dresser here.

DEBUG: Teddy's is deciding
 DEBUG: teddy is in the Your Bedroom

>get on stool
You get onto the kiddie stool.

Mom and yourself

>wait
Time passes.

Mom and yourself

>wait
Time passes.

Mom and yourself

>wait
Time passes.

Mom and yourselfact

>wait
Time passes.

Mom and yourselfact

>wait
Time passes.

Mom and yourself

* * *

>wait
Time passes.

Mom and yourselfact

>turn on lights
"Click." The lights go on.

Mom and yourselfact"Click." The lights go off.

>turn on lights
"Click." The lights go on.

Mom and yourselfact"Click." The lights go off.

>l
Darkness
It is pitch dark, and you can't see a thing.

Mom and yourself

* * *

>get on stool
You get onto the kiddie stool.

Mom and yourself

>turn on lights
"Click." 
The lights go on.

Mom and yourself
My Bedroom (on the kiddie stool)
This is my bedroom. There is a shelf with  a teddy bear on it. 

You can see a roomba and Mom here.

* * *

>n
Your Bedroom
This is your bedroom. There is a shelf with a teddy bear on it. 

You can see a hamper (empty), a high chair, dad, a widget, your bed and a dresser here.

DEBUG: Teddy's is deciding
 DEBUG: teddy is in the Your Bedroom

>w
You can't go that way.

yourself and Mom

>e
Small Hall
Mom

>n
Parent's Bedroom
You can see a roomba here.

Mom

>s
Small Hall
Mom

>w
Darkness
It is pitch dark, and you can't see a thing.

yourself and Mom

>e
Small Hall
Mom

>e
Living Room
Momactother alonedarkkilledone

>e
Laundry Room
You can see a dryer (closed) and a washer (closed) here.

>s
Garage
actother numberdarkchase

>s
You can't go that way.

>k
That's not a verb I recognise.

>i
You are carrying nothing.

actother numberlitwander

>i
You are carrying nothing.

>i
You are carrying nothing.

actother numberdarkchase

>e
You can't go that way.

>s
You can't go that way.

>w
You can't go that way.

>n
Laundry Room
You can see a dryer (closed) and a washer (closed) here.

>e
You can't go that way.

>w
Living Room

>n
Kitchen
You can see a pantry (closed) here.

>s
Living Room

>w
Small Hall
yourself

>s
Bobby's Bedroom
You can see a toybox (closed) here.

>n
Small Hall
yourself

>s
Bobby's Bedroom
You can see a toybox (closed) here.

>s
You can't go that way.

>e
You can't go that way.

actother numberlitwander

>e
You can't go that way.

>w
Shared Bathroom
I share this bathroom with my brother, Bobby.

You can see a mirror here.

>w
You can't go that way.

>e
Bobby's Bedroom
You can see a toybox (closed) here.

>n
Small Hall
actother numberdarkchase

>n
Parent's Bedroom
You can see a roomba here.

>e
You can't go that way.

>w
Parent's Bathroom

>w
You can't go that way.

>n
You can't go that way.

>e
Parent's Bedroom
You can see a roomba here.

>w
Parent's Bathroom
actother numberlitlightsgoout

* * *

>n
Your Bedroom
This is your bedroom. There is a shelf with a teddy bear on it. 

You can see a hamper (empty), a high chair, dad, a widget, your bed and a dresser here.

DEBUG: Teddy's is deciding
 DEBUG: teddy is in the Your Bedroom

>take coin
Fearing discovery, the coin panics!

The coin goes east.

* * *

>n
Your Bedroom
This is your bedroom. There is a shelf with a teddy bear on it. 

You can see a hamper (empty), a high chair, dad, a widget, your bed and a dresser here.

DEBUG: Teddy's is deciding
 DEBUG: teddy is in the Your Bedroom

>drop salt
DEBUG: Teddy heard you
Dropped.

DEBUG: dadvision is empty
DEBUG: dad looking for things
DEBUG:adding salt shaker to dadvision
DEBUG: the stating position of salt shaker is the shared bathroom
Dad picks up the salt shaker.

Dad goes south.

DEBUG: dad is chasing to put away salt shaker

DEBUG: Teddy's is deciding
 DEBUG: teddy is in the Your Bedroom

>s
shared bathroom
I share this bathroom with my brother, Bobby.

You can see a salt shaker, dad, a high chair and a mirror here.

DEBUG: dadvision is empty
DEBUG: dad looking for things
DEBUG: dad is chasing to put away salt shaker

DEBUG: Teddy's is deciding
 DEBUG: teddy is in the Your Bedroom

* * *

>s
You can't go that way.

DEBUG: Teddy's is deciding
 DEBUG: teddy is in the Your Bedroom

>go south
You can't see any such thing.

* * *

>s
You can't go that way.

DEBUG: Teddy's is deciding
 DEBUG: teddy is in the Your Bedroom

>l
Shared Bathroom
I share this bathroom with my brother, Bobby.

You can see Mom, a rubber ball, Chaser and a mirror here.

Chaser trots up to you, and gives you a friendly lick on the cheek.
mom is light-policing 
mom is locating salt 

Mom goes north.

teddy is in the Your Bedroom

>n
Darkness
It is pitch dark, and you can't see a thing.

yourselfact

    *** Teddy got you. ***

Would you like to RESTART, RESTORE a saved game, QUIT or UNDO the last command?

* * *

>l
Shared Bathroom
I share this bathroom with my brother, Bobby.

You can see Mom, a rubber ball, Chaser and a mirror here.

Chaser trots up to you, and gives you a friendly lick on the cheek.
mom is light-policing 
mom is locating salt 

Mom goes north.

teddy is in the Your Bedroom

>l
Shared Bathroom
I share this bathroom with my brother, Bobby.

You can see a rubber ball, Chaser and a mirror here.

DEBUG: Chaser is wandering to the Shared Bathroommom is light-policing 
mom is locating salt 

Mom arrives from the north.

teddy is in the Your Bedroom

>l
Shared Bathroom
I share this bathroom with my brother, Bobby.

You can see Mom, a rubber ball, Chaser and a mirror here.

Chaser rolls on his back, exposing his belly.
teddy is in the Your Bedroom

>l
Shared Bathroom
I share this bathroom with my brother, Bobby.

You can see Mom, a rubber ball, Chaser and a mirror here.

Chaser uses his hind leg to scratch his ear.
mom is light-policing 
mom is locating salt 
teddy is in the Your Bedroom

>l
Shared Bathroom
I share this bathroom with my brother, Bobby.

You can see Mom, a rubber ball, Chaser and a mirror here.

DEBUG: Chaser is wandering to the Shared Bathroommom is light-policing 
mom is locating salt 
teddy is in the Your Bedroom

>l
Shared Bathroom
I share this bathroom with my brother, Bobby.

You can see Mom, a rubber ball, Chaser and a mirror here.

mom is light-policing 
mom is locating salt 

Mom goes north.

teddy is in the Your Bedroom

>l
Shared Bathroom
I share this bathroom with my brother, Bobby.

You can see a rubber ball, Chaser and a mirror here.

DEBUG: Chaser is wandering to the Shared Bathroomteddy is in the Your Bedroom

* * *

>s
You can't go that way.

DEBUG: Teddy's is deciding
 DEBUG: teddy is in the Your Bedroom

>look in mirror
I can see myself in it.

>l
Shared Bathroom
I share this bathroom with my brother, Bobby.

You can see a mirror here.

* * *

>look in mirror
I can see myself in it.

>wait
Time passes.

>look
Shared Bathroom
I share this bathroom with my brother, Bobby.

You can see a mirror here.

>look in mirror
I can see myself in it.

>i
You are carrying nothing.

>look in mirror
I can see myself in it.

* * *

>examine mirror
I can see myself in it.

>wait
Time passes.

>wait
Time passes.

"Click."

>l
Shared Bathroom
I share this bathroom with my brother, Bobby.

You can see a mirror here.

>wait
Time passes.

* * *

>wait
Time passes.

>wait
Time passes.

teddy hunt on

>look in mirror
I can see myself in it.

* * *

>wait
Time passes.

teddy hunt on

>wait
Time passes.

* * *

>s
You can't go that way.

DEBUG: Teddy's is deciding
 DEBUG: teddy is in the Your Bedroom

>wait
Time passes.

DEBUG: dadvision is empty
DEBUG: dad looking for things
DEBUG:adding dad to dadvision
DEBUG: the stating position of dad is the Your Bedroom

DEBUG:adding rubber ball to dadvision
DEBUG: the stating position of rubber ball is the Parent's Bathroom
Dad picks up the rubber ball.

DEBUG:adding floor to dadvision
DEBUG: the stating position of floor is the Your Bedroom

DEBUG:adding light switch to dadvision
DEBUG: the stating position of light switch is the Your Bedroom

DEBUG:adding yourself to dadvision
DEBUG: the stating position of yourself is the Your Bedroom

DEBUG:adding Chaser to dadvision
DEBUG: the stating position of Chaser is the Your Bedroom

DEBUG:adding mirror to dadvision
DEBUG: the stating position of mirror is the Your Bedroom

DEBUG: dad is chasingmom is light-policing 
mom is locating salt 

DEBUG: Mom wanders to the Kitchen
DEBUG: Teddy's is deciding
 DEBUG: teddy is in the Your Bedroom

>wait
Time passes.

Chaser rolls on his back, exposing his belly.
teddy is in the Your Bedroom

>wait
Time passes.

Momactother alonelitlightsgoout
to saltShared Bathroom0 unsaltedShared Bathroom
It is now pitch dark in here!

>wait
Time passes.

Mom

>wait
Time passes.

Momactother alonedarkkilledone

>wait
Time passes.

Mom

>wait
Time passes.

Momactotherlit

>wait
Time passes.

>wai
That's not a verb I recognise.

>l
Shared Bathroom
I share this bathroom with my brother, Bobby.

You can see a mirror here.

>look in mirror
I can see myself in it.

>n
Darkness
It is pitch dark, and you can't see a thing.

>get on stool
You get onto the kiddie stool.

* * *

>wait
Time passes.

>look in mirror
I can see myself in it.
teddy hunt on

>look in mirror
I can see myself in it.
teddy hunt on

* * *

>wait
Time passes.

>look in mirror
I can see myself in it.

* * *

>wait
Time passes.

>ait
That's not a verb I recognise.

>wait
Time passes.

>l
Shared Bathroom
I share this bathroom with my brother, Bobby.

You can see a mirror here.

* * *

>look in mirror
I can see myself in it.

>n
My Bedroom
This is my bedroom. There is a shelf with nothing on it.

You can see Mom, a kiddie stool and a salt here.

* * *

>l
Shared Bathroom
I share this bathroom with my brother, Bobby.

You can see a mirror here.

>n
My Bedroom
This is my bedroom. There is a shelf with nothing on it.

You can see Mom, a kiddie stool and a salt here.

"Click." The lights go off.

It is now pitch dark in here!

>s
Shared Bathroom
I share this bathroom with my brother, Bobby.

You can see a mirror here.

>wait
Time passes.

"Click." The lights go off.

It is now pitch dark in here!

* * *

>wait
Time passes.

    *** Teddy got you. ***

Would you like to RESTART, RESTORE a saved game, QUIT or UNDO the last command?

>undo
Darkness
[Previous turn undone.]

>get on stool
You can't reach into the My Bedroom.

>n
Darkness
It is pitch dark, and you can't see a thing.

* * *

>wait
Time passes.

>look
My Bedroom (on the kiddie stool)
This is my bedroom. There is a shelf with nothing on it.

You can see Mom and a salt here.

>wait
Time passes.

>look
My Bedroom (on the kiddie stool)
This is my bedroom. There is a shelf with  a teddy bear on it. 

You can see Mom and a salt here.

>wait
Time passes.

* * *

>look
My Bedroom (on the kiddie stool)
This is my bedroom. There is a shelf with  a teddy bear on it. 

You can see Mom and a salt here.

>s
(first getting off the kiddie stool)

Darkness
It is pitch dark, and you can't see a thing.

>turn on lights
You're too small to reach it.

>n
My Bedroom
This is my bedroom. There is a shelf with  a teddy bear on it. 

You can see Mom, a kiddie stool and a salt here.

>wait
Time passes.

>look in mirror
I can see myself in it, with a teddy bear behind me.

>wait
Time passes.

>wait
Time passes.

loc lit noc now carries teddy

>i
You are carrying:
  Teddy

"Click." The lights go off.
loc lit carry now dark
It is now pitch dark in here!

>wait
Time passes.

    *** Teddy got you. ***

Would you like to RESTART, RESTORE a saved game, QUIT or UNDO the last command?

>restart
Bad Teddy
An Interactive Fiction by "Y'Gael of Atrii" this is a subtitle
Release 1 / Serial number 201215 / Inform 7 build 6M62 (I6/v6.33 lib 6/12N) SD

Darkness
It is pitch dark, and you can't see a thing.

* * *

>i
You are carrying nothing.

>n
My Bedroom
This is my bedroom. There is a shelf with nothing on it.

You can see Mom, a kiddie stool and a salt here.

>wait
Time passes.

>l
My Bedroom
This is my bedroom. There is a shelf with nothing on it.

You can see Mom, a kiddie stool and a salt here.

>s
Shared Bathroom
I share this bathroom with my brother, Bobby.

You can see a mirror here.

>look in mirror
I can see myself in it.

* * *

>wait
Time passes.

Momactotherlit

>n
My Bedroom
This is my bedroom. There is a shelf with  a teddy bear on it. 

You can see Mom, a kiddie stool and a salt here.

yourself and Momacttwolitnot carried

>wait
Time passes.

>e
Small Hall

>s
Bobby's Bedroom

* * *

>wait
Time passes.

Mom

>look in mirror
I can see myself in it.
teddy hunt on

>wait
Time passes.

* * *

>wait
Time passes.

Momactother alonedarkkilledone

>s
You can't go that way.

>e
Bobby's Bedroom
actother numberdarkchase

>e
You can't go that way.

>w
Shared Bathroom
I share this bathroom with my brother, Bobby.

You can see a mirror here.

yourself

>e
Bobby's Bedroom
actother numberlitlightsgoout

>n
Small Hall

>e
Living Room

>e
Laundry Room
actother numberdarkchase

>s
Garage
actother numberdarkchase

* * *

>wait
Time passes.

Momactother alonelitlightsgoout
to saltShared Bathroom0 unsaltedShared Bathroom
It is now pitch dark in here!

>look in mirror
I can see myself in it.
"Click." The lights go off.

It is now pitch dark in here!

>look in mirror
You can't see any such thing.

>n
My Bedroom
This is my bedroom. There is a shelf with nothing on it.

You can see Mom, a kiddie stool and a salt here.

>push stool south
You push the kiddie stool south to the Shared Bathroom.

Darkness
It is pitch dark, and you can't see a thing.

>get on stool
You get onto the kiddie stool.

>turn on light
"Click." The lights go on.

Shared Bathroom (on the kiddie stool)
I share this bathroom with my brother, Bobby.

You can see a mirror here.

>look in mirror
I can see myself in it.

>i
You are carrying:
  Teddy

* * *

>wait
Time passes.

Momactother alonelitlightsgoout
to saltShared Bathroom0 unsaltedShared Bathroom
It is now pitch dark in here!

>undo
Shared Bathroom
[Previous turn undone.]

>wait
Time passes.

Mom
Mom arrives from the north.

to saltShared Bathroom0 unsaltedShared Bathroom

>wait
Time passes.

actother numberlitwander

* * *

>wait
Time passes.

Chaser rolls on his back, exposing his belly.
teddy is in the Your Bedroom

>l
Shared Bathroom
I share this bathroom with my brother, Bobby.

You can see a mirror here.

>l
Shared Bathroom
I share this bathroom with my brother, Bobby.

You can see a mirror here.

>i
You are carrying nothing.

>i
You are carrying nothing.

teddy hunt on

>i
You are carrying nothing.

teddy hunt on

>look in mirror
I can see myself in it.

* * *

>wait
Time passes.

>l
Shared Bathroom
I share this bathroom with my brother, Bobby.

You can see a mirror here.

teddy hunt on

>cry
teddy hunt on

>wait
Time passes.

* * *

>look in mirror
I can see myself in it.

>look in mirror
I can see myself in it.

* * *

>wait
Time passes.

teddy hunt on

>n
Darkness
It is pitch dark, and you can't see a thing.

    *** Teddy got you. ***

Would you like to RESTART, RESTORE a saved game, QUIT or UNDO the last command?

>undo
Shared Bathroom
[Previous turn undone.]

>s
You can't go that way.

teddy hunt on

>e
Bobby's Bedroom

>e
You can't go that way.

* * *

>s
You can't go that way.

>n
Small Hall

* * *

>e
Living Room

>s
Entry Hall

>s
You can't go that way.

* * *

>w
You can't go that way.

>e
You can't go that way.

* * *

>wait
Time passes.

Chaser rolls on his back, exposing his belly.
teddy is in the Your Bedroom

>i
You are carrying:
  a salt shaker
  your lucky boxers

>i
You are carrying:
  a salt shaker
  your lucky boxers

>l
Shared Bathroom
I share this bathroom with my brother, Bobby.

You can see a rubber ball, Chaser and a mirror here.

Chaser uses his hind leg to scratch his ear.
mom is light-policing 
mom is locating salt 

teddy is in the Your Bedroom

* * *

>n
My Bedroom
This is my bedroom. There is a shelf with  a teddy bear on it. 

You can see a kiddie stool, a my bed and a dresser here.

yourselfhere

>wait
Time passes.

>s
Shared Bathroom
I share this bathroom with my brother, Bobby.

You can see a mirror here.

"Click." The lights go off.

It is now pitch dark in here!

>n
My Bedroom
This is my bedroom. There is a shelf with nothing on it.

You can see Mom, a kiddie stool and a salt here.

"Click." The lights go off.

It is now pitch dark in here!

>wait
Time passes.

>get on stool
You get onto the kiddie stool.

>turn on lights
"Click." The lights go on.

My Bedroom (on the kiddie stool)
This is my bedroom. There is a shelf with nothing on it.

You can see a salt here.

>wait
Time passes.

>l
My Bedroom (on the kiddie stool)
This is my bedroom. There is a shelf with nothing on it.

You can see a salt here.

>l
My Bedroom (on the kiddie stool)
This is my bedroom. There is a shelf with nothing on it.

You can see a salt here.

>s
(first getting off the kiddie stool)

Darkness
It is pitch dark, and you can't see a thing.

    *** Teddy got you. ***

Would you like to RESTART, RESTORE a saved game, QUIT or UNDO the last command?

* * *

>n
My Bedroom
This is my bedroom. There is a shelf with  a teddy bear on it. 

You can see a kiddie stool, a my bed and a dresser here.

yourselfhere

>i
You are carrying nothing.

* * *

>n
My Bedroom
This is my bedroom. There is a shelf with  a teddy bear on it. 

You can see a kiddie stool, a my bed and a dresser here.

yourselfhere

>e
Small Hall
You can see Mom and a hall closet (closed) here.

here

>wait
Time passes.

here

>open cabinet
You can't see any such thing.

>open closet
You open the hall closet, revealing a vacuum cleaner.

actother numberlitwanderhere

* * *

>l
Shared Bathroom
I share this bathroom with my brother, Bobby.

You can see a mirror here.

>look in mirror
I can see myself in it, with a teddy bear behind me.

>n
My Bedroom
This is my bedroom. There is a shelf with nothing on it.

You can see Mom, a kiddie stool and a salt here.

* * *

>s
You can't go that way.

DEBUG: Teddy's is deciding
 DEBUG: teddy is in the Your Bedroom

>s
You can't go that way.

DEBUG: dadvision is empty
DEBUG: dad looking for thingsmom is light-policing 
mom is locating salt 

DEBUG: Mom wanders to the Entry Hall
DEBUG: Teddy's is deciding
 DEBUG: teddy is in the Your Bedroom

>wait
Time passes.

* * *

>look in mirror
I can see myself in it.

>wait
Time passes.

teddy hunt on

>look in mirror
I can see myself in it.
teddy hunt on

* * *

>s
You can't go that way.

DEBUG: dadvision is empty
DEBUG: dad looking for thingsmom is light-policing 
mom is locating salt 

DEBUG: Mom wanders to the Entry Hall
DEBUG: Teddy's is deciding
 DEBUG: teddy is in the Your Bedroom

>n
Your Bedroom
This is your bedroom. There is a shelf with a teddy bear on it. 

You can see dad, a widget, your bed and a dresser here.

DEBUG: dadvision is empty
DEBUG: dad looking for things
DEBUG: Teddy's is deciding
 DEBUG: teddy is in the Your Bedroom

* * *

>s
You can't go that way.

DEBUG: Teddy's is deciding
 DEBUG: teddy is in the Your Bedroom

>examine teddy
You see nothing special about Teddy.

* * *

>s
You can't go that way.

DEBUG: Teddy's is deciding
 DEBUG: teddy is in the Your Bedroom

>waait
That's not a verb I recognise.

>wait
Time passes.

Mom

>wait
Time passes.

Momactother alonedark

* * *

>s
You can't go that way.

DEBUG: Teddy's is deciding
 DEBUG: teddy is in the Your Bedroom

>e
Bobby's Bedroom
You can see a toybox (closed) here.

DEBUG: dadvision is empty
DEBUG: dad looking for thingsmom is light-policing 
mom is locating salt 

Mom arrives from the east.

DEBUG: Mom wanders to the Bobby's Bedroom
DEBUG: Teddy's is deciding 
DEBUG: teddy acts
 DEBUG: teddy is in the Your Bedroom

>e
Entry Hall
You can see a front door here.

DEBUG: dadvision is empty
DEBUG: dad looking for things
DEBUG: Teddy's is deciding
 DEBUG: teddy is in the Your Bedroom

>s
You can't go that way.

Momactother alonelitlightsgoout

>n
Small Hall
Mom

>w
Darkness
It is pitch dark, and you can't see a thing.

yourself and Mom

>get on stool
You get onto the kiddie stool.

Mom and yourself

>turn on lights
Mom and yourselfacttwolitnot carriedcarrymelightsgoout

>i
You are carrying nothing.

Mom and yourself

>l
Darkness
It is pitch dark, and you can't see a thing.

Mom and yourself

>turn on lights
Mom and yourself
My Bedroom (on the kiddie stool)
This is my bedroom. There is a shelf with  a teddy bear on it. 

You can see Mom and a salt here.

* * *

>e
Entry Hall
You can see a front door here.

DEBUG: dadvision is empty
DEBUG: dad looking for things
DEBUG: Teddy's is deciding
 DEBUG: teddy is in the Your Bedroom

>n
Small Hall
Mom

>n
Parent's Bedroom
Mom

>w
Parent's Bathroom
Mom

>w
You can't go that way.

Mom

>e
Parent's Bedroom
Mom

>s
Small Hall
Mom

>e
Living Room
Mom

>w
Small Hall
Momactother alonelitlightsgoout

>w
Darkness
It is pitch dark, and you can't see a thing.

yourself and Mom

>s
Shared Bathroom
I share this bathroom with my brother, Bobby.

You can see a mirror here.

Mom

* * *

>e
Entry Hall
You can see a front door here.

DEBUG: dadvision is empty
DEBUG: dad looking for things
DEBUG: Teddy's is deciding
 DEBUG: teddy is in the Your Bedroom

>push high chair w
Pushing the high chair is difficult and noisy. Time passes.

You push the high chair west to the Bobby's Bedroom.

DEBUG: Teddy heard you
Bobby's Bedroom
You can see Chaser and a toybox (closed) here.

DEBUG: dadvision is empty
DEBUG: dad looking for thingsmom is light-policing 
mom is locating salt 

DEBUG: Mom wanders to the Your Bedroom
DEBUG: Teddy's is deciding
 DEBUG: teddy is in the shared bathroom

>push high chair w
Pushing the high chair is difficult and noisy. Time passes.

You push the high chair west to the shared bathroom.

DEBUG: Teddy heard you
shared bathroom
I share this bathroom with my brother, Bobby.

You can see a mirror here.

DEBUG: dadvision is empty
DEBUG: dad looking for thingsmom is light-policing 
mom is locating salt 

DEBUG: Mom wanders to the Small Hall
DEBUG: Teddy's is deciding
 DEBUG: teddy is in the shared bathroom

>push high chair n
Pushing the high chair is difficult and noisy. Time passes.

You push the high chair north to the Your Bedroom.

DEBUG: Teddy heard you
Your Bedroom
This is your bedroom. There is a shelf with a teddy bear on it. 

You can see a hamper (empty), dad, a widget, your bed and a dresser here.

DEBUG: dadvision is empty
DEBUG: dad looking for things
DEBUG:adding high chair to dadvision
DEBUG: the stating position of high chair is the Entry Hall
Dad goes east, pushing the high chair away.

DEBUG: dad is chasing to put away high chair
DEBUG: Teddy's is deciding
 DEBUG: teddy is in the Your Bedroom

>e
Small Hall
You can see a high chair, Mom and a hall closet (closed) here.

DEBUG: dadvision is empty
DEBUG: dad looking for things

DEBUG: dad is chasing to put away high chair
mom is light-policing 
mom is locating salt 

Mom goes north.

DEBUG: Mom wanders to the Parent's Bedroom
DEBUG: Teddy's is deciding
 DEBUG: teddy is in the Your Bedroom

>e
Living Room

DEBUG: dadvision is empty
DEBUG: dad looking for things
DEBUG: Teddy's is deciding
 DEBUG: teddy is in the Your Bedroom

>s
Entry Hall
You can see dad and a front door here.

DEBUG: dadvision is empty
DEBUG: dad looking for things
DEBUG: Teddy's is deciding 
DEBUG: teddy acts
 DEBUG: teddy is in the Your Bedroom

* * *

>e
Entry Hall
You can see a front door here.

DEBUG: dadvision is empty
DEBUG: dad looking for things
DEBUG: Teddy's is deciding
 DEBUG: teddy is in the Your Bedroom

>e
Play Room

DEBUG: dadvision is empty
DEBUG: dad looking for things
DEBUG: Teddy's is deciding
 DEBUG: teddy is in the Your Bedroom

>e
Garage

DEBUG: dadvision is empty
DEBUG: dad looking for thingsmom is light-policing 
mom is locating salt 

DEBUG: Mom wanders to the Entry Hall
DEBUG: Teddy's is deciding 
DEBUG: teddy acts
 DEBUG: teddy is in the Your Bedroom

>w
Play Room

DEBUG: dadvision is empty
DEBUG: dad looking for thingsmom is light-policing 
mom is locating salt 

DEBUG: Mom wanders to the Living Room
DEBUG: Teddy's is deciding
 DEBUG: teddy is in the Your Bedroom

>n
Laundry Room
You can see a hamper (empty), a washer (closed) and a dryer (closed) here.

DEBUG: dadvision is empty
DEBUG: dad looking for thingsmom is light-policing 
mom is locating salt 

DEBUG: Mom wanders to the Kitchen
DEBUG: Teddy's is deciding 
DEBUG: teddy acts
DEBUG: Teddy wanders to the Small Hall
 DEBUG: teddy is in the Small Hall

>w
Living Room

DEBUG: dadvision is empty
DEBUG: dad looking for things
DEBUG: Teddy's is deciding
 DEBUG: teddy is in the Small Hall

>w
Small Hall
You can see a dog bed (on which is a rubber ball) and a hall closet (closed) here.

DEBUG: dadvision is empty
DEBUG: dad looking for things
DEBUG: Teddy's is deciding
 DEBUG: teddy is in the Small Hall

>n
Parent's Bedroom
You can see a step stool here.

DEBUG: dadvision is empty
DEBUG: dad looking for things
DEBUG: Teddy's is deciding
 DEBUG: teddy is in the Small Hall

>push stool s
Pushing the step stool is difficult and noisy. Time passes.

You push the step stool south to the Small Hall.

DEBUG: Teddy heard you
Small Hall
You can see a dog bed (on which is a rubber ball) and a hall closet (closed) here.

DEBUG: dadvision is empty
DEBUG: dad looking for things
DEBUG: Teddy's is deciding
 DEBUG: teddy is in the Small Hall

>push stool w
Pushing the step stool is difficult and noisy. Time passes.

You push the step stool west to the Your Bedroom.

DEBUG: Teddy heard you
Darkness
It is pitch dark, and you can't see a thing.

DEBUG: dadvision is empty
DEBUG: dad looking for thingsmom is light-policing 
mom is locating salt 

DEBUG: Mom wanders to the Living Room
DEBUG: Teddy's is deciding
 DEBUG: teddy is in the Your Bedroom

>get on stool
You get onto the step stool.

DEBUG: dadvision is empty
DEBUG: dad looking for thingsmom is light-policing 
mom is locating salt 

DEBUG: Mom wanders to the Kitchen
DEBUG: Teddy's is deciding
 DEBUG: teddy is in the Your Bedroom

>turn on light
"Click." 
The lights go on.

DEBUG: dadvision is empty
DEBUG: dad looking for thingsmom is light-policing 
mom is locating salt 

DEBUG: Mom wanders to the Dining Room
DEBUG: Teddy's is deciding
 DEBUG: teddy is in the Your Bedroom

>l
Your Bedroom (on the step stool)
This is your bedroom. There is a shelf with a teddy bear on it. 

You can see a high chair, a widget, your bed and a dresser here.

DEBUG: dadvision is empty
DEBUG: dad looking for thingsmom is light-policing 
mom is locating salt 

DEBUG: Mom wanders to the Laundry Room
DEBUG: Teddy's is deciding 
DEBUG: teddy acts
 DEBUG: teddy is in the Your Bedroom

>push chair s
(first getting off the step stool)
Pushing the high chair is difficult and noisy. Time passes.

You push the high chair south to the shared bathroom.

DEBUG: Teddy heard you
shared bathroom
I share this bathroom with my brother, Bobby.

You can see Chaser and a mirror here.

DEBUG: dadvision is empty
DEBUG: dad looking for things
DEBUG: Teddy's is deciding
 DEBUG: teddy is in the shared bathroom

* * *

>e
Bobby's Bedroom
You can see a toybox (closed) here.

DEBUG: dadvision is empty
DEBUG: dad looking for thingsmom is light-policing 
mom is locating salt 

Mom arrives from the east.

DEBUG: Mom wanders to the Bobby's Bedroom
DEBUG: Teddy's is deciding 
DEBUG: teddy acts
 DEBUG: teddy is in the Your Bedroom

>n
Small Hall
You can see Mom and a hall closet (closed) here.

Mom goes west.

to saltShared Bathroom1

>e
Living Room
You can see Mom here.

>take mom
I don't suppose Mom would care for that.

* * *

>n
Small Hall
You can see Mom and a hall closet (closed) here.

Mom goes west.

to saltShared Bathroom1

>open closet
You open the hall closet.

Mom
to saltShared Bathroom0 You hear the whirring of a vacuum cleaner some distance away.
Shared Bathroom

* * *

>s
You can't go that way.

DEBUG: Teddy's is deciding
 DEBUG: teddy is in the Your Bedroom

>pour salt on ground
You pour some salt on the floor.

the Shared Bathroom is salted.
Mom sees you pouring salt on the floor.
"My floor! No! You're getting a time-out for this right now!"
Mom drags you to a corner of your bedroom for a 10-minute time-out.

mom is light-policing 
mom is locating salt 
Why is there salt all over the floor?
mom sees the salt in Shared Bathroom
mom is vacuum-fetching
mom is fetching the vacuum 

Mom goes north.

teddy is in the Your Bedroom

>wait
Time passes.

turnno vacuume timeMom is wandering
mom wanders

>wait
Time passes.

turnno vacuume timeMom is wanderingmom wandersactother numberlitwanderTeddy is wandering

>wait
Time passes.

turnno vacuume timeMom is wandering
mom wanders

>e
Bobby's Bedroom
You can see a toybox (closed) here.

turnno vacuume timeMom is wandering
mom wanders

>pour salt on ground
You pour the salt on the floor.

turnno vacuume timeMom is wandering
mom wanders

>e
You can't go that way.

turnno vacuume timeMom is wandering
mom wandersactother numberlitwanderTeddy is wandering

>e
You can't go that way.

turn

>w
Shared Bathroom
I share this bathroom with my brother, Bobby.

You can see Mom and a mirror here.

turnvaccum timesalted room

>n
Your Bedroom
This is your bedroom. There is a shelf with nothing on it.

You can see a kiddie stool, your bed and a dresser here.

turnvaccum timesalted room

>e
Small Hall
You can see a hall closet (closed) here.

turnvaccum timesalted room
yourself

>e
Living Room
turnvaccum timesalted room
actother numberlitwanderTeddy is wandering

>pour salt on ground
You pour the salt on the floor.

turnvaccum timesalted room

>wait
Time passes.

turnvaccum timesalted room
actother numberlitlightsgoout

>ACTIONS
Actions listing on.

>wait
[waiting]
Time passes.
[waiting - succeeded]

turnvaccum timesalted room
[Mom going east]
[Mom going east - failed the can't go that way rule]

* * *

>wait
Time passes.

turnno vacuume timeMom is wandering
mom wanders

>n
Your Bedroom
This is your bedroom. There is a shelf with nothing on it.

You can see a kiddie stool, your bed and a dresser here.

turnno vacuume timeMom is wanderingmom wandersactother numberlitlightsgoout

>e
Small Hall
You can see Mom and a hall closet (closed) here.

turnno vacuume timeMom is wandering
Mom goes west.

mom wandersactother numberlitwanderTeddy is wandering

>pour salt on ground
You pour the salt on the floor.

turnno vacuume timeMom is wandering
mom wandersTeddy is wandering

>e
Living Room
turn

>pour salt on ground
You pour the salt on the floor.

turn

>e
Laundry Room
You can see a dryer (closed) and a washer (closed) here.

turnyourself

>s
Garage
turn

>n
Laundry Room
You can see a dryer (closed) and a washer (closed) here.

turnyourself

>wait
Time passes.

turnyourself

>wait
Time passes.

turnyourself

>wait
Time passes.

turnyourselfactyou alonelitnot carried

>wait
Time passes.

turnyourselfactyou alonelitcarried

>wait
Time passes.

turnyourself

>e
You can't go that way.

turnyourself

>e
You can't go that way.

turnyourselfactyou alonelitcarried

>w
Living Room
turnTeddy is wandering

>w
Small Hall
You can see a hall closet (closed) here.

turnactother numberlitwanderTeddy is wandering

>s
Bobby's Bedroom
You can see a toybox (closed) here.

turn

>s
You can't go that way.

turn

* * *

>s
You can't go that way.

DEBUG: Teddy's is deciding
 DEBUG: teddy is in the Your Bedroom

>throw ball
The ball is already here.

The family dog, chaser, bounds up to you with a rubber ball in his mouth.

He looks up at you expectantly, his tail wagging.
teddy is in the Your Bedroom

* * *

>s
You can't go that way.

DEBUG: Teddy's is deciding
 DEBUG: teddy is in the Your Bedroom

>throw ball south
You throw the rubber ball to the south
The family dog, chaser, bounds up to you with a rubber ball in his mouth.

He looks up at you expectantly, his tail wagging.
teddy is in the Your Bedroom

>s
You can't go that way.

The family dog, chaser, bounds up to you with a rubber ball in his mouth.

He looks up at you expectantly, his tail wagging.
teddy is in the Your Bedroom

>i
You are carrying:
  your lucky boxers
  a salt shaker

>throw boxers east
You throw the lucky boxers to the east
The family dog, chaser, bounds up to you with a rubber ball in his mouth.

He looks up at you expectantly, his tail wagging.
mom is light-policing 
mom is locating salt 
teddy is in the Your Bedroom

>e
Bobby's Bedroom
You can see a toybox (closed) here.

teddy is in the Your Bedroom

* * *

>s
You can't go that way.

DEBUG: Teddy's is deciding
 DEBUG: teddy is in the Your Bedroom

>throw ball s
Chaser catches the rubber ball in mid air. He drops it at your feet and looks at you expectantly.

Chaser rolls on his back, exposing his belly.
mom is light-policing 
mom is locating salt 

Mom goes north.

teddy is in the Your Bedroom

>throw ball n
You throw the rubber ball to the northChaser bounds after the ball, tail wagging.

mom is light-policing 
mom is locating salt 

Mom goes north.

teddy is in the Your Bedroom

>n
Your Bedroom
This is your bedroom. There is a shelf with a teddy bear on it. 

You can see Mom, Chaser, a rubber ball, a step stool, your bed, a dresser and a hamper (empty) here.

mom is light-policing 
mom is locating salt 

Mom goes south.

teddy is in the Your Bedroom

* * *

>s
You can't go that way.

DEBUG: Teddy's is deciding
 DEBUG: teddy is in the Your Bedroom

>take ball
Taken.

DEBUG: Chaser is wandering to the Small Hallmom is light-policing 
mom is locating salt 
DEBUG: Mom wanders to the Shared Bathroomteddy is in the Your Bedroom

>s
You can't go that way.

Chaser chases his tail for a moment, then lazily slumps in the corner.
teddy is in the Your Bedroom

>s
You can't go that way.

Chaser rolls on his back, exposing his belly.
teddy is in the Your Bedroom

>s
You can't go that way.

Chaser trots up to you, and gives you a friendly lick on the cheek.
teddy is in the Your Bedroom

>wait
Time passes.

Chaser rolls on his back, exposing his belly.
teddy is in the Your Bedroom

>wait
Time passes.

Chaser uses his hind leg to scratch his ear.
teddy is in the Your Bedroom

>wait
Time passes.

Chaser uses his hind leg to scratch his ear.
teddy is in the Your Bedroom

>wait
Time passes.

Chaser uses his hind leg to scratch his ear.
mom is light-policing 
mom is locating salt 

Mom goes north.

teddy is in the Your Bedroom

>wait
Time passes.

mom is light-policing 
mom is locating salt 

teddy is in the Your Bedroom

>l
Shared Bathroom
I share this bathroom with my brother, Bobby.

You can see Chaser and a mirror here.

Chaser chases his tail for a moment, then lazily slumps in the corner.
mom is light-policing 
mom is locating salt 

teddy is in the Your Bedroom

* * *

>take ball
Taken.

DEBUG: Chaser is wandering to the Small Hallmom is light-policing 
mom is locating salt 
DEBUG: Mom wanders to the Shared Bathroomteddy is in the Your Bedroom

>inventory
You are carrying:
  a rubber ball
  a salt shaker
  your lucky boxers

>i
You are carrying:
  a rubber ball
  a salt shaker
  your lucky boxers

>throw ball
DEBUG: Teddy heard you
Dropped.

mom is light-policing 
mom is locating salt 
DEBUG: Mom wanders to the Shared Bathroomteddy is in the Shared Bathroom

>throw ball north
You throw the rubber ball to the north
mom is light-policing 
mom is locating salt 
DEBUG: Mom wanders to the Shared Bathroomteddy is in the Shared Bathroom

>l
Shared Bathroom
I share this bathroom with my brother, Bobby.

You can see Mom, a salt shaker and a mirror here.

DEBUG: Chaser is wandering to the Shared Bathroomteddy is in the Shared Bathroom

>follow chaser
That's not a verb I recognise.

>go to the kitchen
You can't see any such thing.

>go south
You can't go that way.

mom is light-policing 
mom is locating salt 
DEBUG: Mom wanders to the Small Hallteddy is in the Shared Bathroom

>l
Shared Bathroom
I share this bathroom with my brother, Bobby.

You can see Chaser, a salt shaker and a mirror here.

mom is light-policing 
mom is locating salt 
DEBUG: Mom wanders to the Small Hallteddy is in the Shared Bathroom

>w
You can't go that way.

teddy is in the Shared Bathroom

>e
Bobby's Bedroom
You can see a toybox (closed) here.

mom is light-policing 
mom is locating salt 
DEBUG: Mom wanders to the Small Hallteddy is in the Shared Bathroom

* * *

>s
You can't go that way.

DEBUG: Teddy's is deciding
 DEBUG: teddy is in the Your Bedroom

>pet chaser
You rub chaser's belly. "Good boy!"
teddy is in the Your Bedroom

>n
Your Bedroom
This is your bedroom. There is a shelf with a teddy bear on it. 

You can see Mom, a step stool, your bed, a dresser and a hamper (empty) here.

teddy is in the Your Bedroom

>pet chaser
You can't see any such thing.

* * *

>ACTIONS
Actions listing on.

>talk to mom
That's not a verb I recognise.

>say hi to mom
[answering Mom that "hi"]
There is no reply.
[answering Mom that "hi" - succeeded]

>tell mom that "hi"
I didn't understand that sentence.

>ask mom hi
I didn't understand that sentence.

>ask mom
What do you want to ask Mom for?

>hi
You can't see any such thing.

>tell mom that "hi"
I didn't understand that sentence.

>hell mom
That's not a verb I recognise.

>tell mom
I didn't understand that sentence.

* * *

>ACTIONS
Actions listing on.

>get on kiddie stool
[entering the kiddie stool]
You get onto the kiddie stool.

[entering the kiddie stool - succeeded]

* * *

>ACTIONS
Actions listing on.

>EXAMINE MOM
[examining Mom]
You see nothing special about Mom.

[examining Mom - succeeded]

"Click."
It is now pitch dark in here!

* * *

>ACTIONS
Actions listing on.

>PUSH STOOL E
[pushing the kiddie stool to east]
[(1) going east]
You push the kiddie stool east to the Small Hall.

Small Hall
You can see a hall closet (closed) here.

[(1) going east - succeeded]

[pushing the kiddie stool to east - succeeded]

turnno vacuume time
[Mom going south]
[Mom going south - succeeded]

mom wandersBobby

* * *

>ACTIONS
Actions listing on.

>E
[going east]

Small Hall
You can see a hall closet (closed) here.

[going east - succeeded]

turnno vacuume timeMom is wandering
[Mom going south]
[Mom going south - succeeded]

mom wandersactother numberlitwanderTeddy is wandering[Teddy going west - silently]
[Teddy going west - silently - succeeded]

>OPEN CLOSET
[opening the hall closet]
You open the hall closet, revealing a vacuum cleaner.
[opening the hall closet - succeeded]

turnno vacuume time
[Mom going north]
[Mom going north - succeeded]

mom wanders

>TAKE VACUUM
[taking the vacuum cleaner]
Taken.
[taking the vacuum cleaner - succeeded]

turnno vacuume time
[Mom going south]
[Mom going south - succeeded]

mom wanders

>E
[going east]

Living Room
[going east - succeeded]

turnno vacuume timemom wanders

>POUR SALT
What do you want to pour salt on?

>GROUND
[salting the floor]
You pour the salt on the floor.
[salting the floor - succeeded]

turnvaccum timesalted room
[Mom going east]
[Mom going east - succeeded]

>WAIT
[waiting]
Time passes.
[waiting - succeeded]

turnvaccum timesalted room
[Mom going east]
[Mom going east - failed the can't go that way rule]

actother numberlitlightsgoout

>e
[going east]

Laundry Room
You can see a dryer (closed) and a washer (closed) here.

[going east - succeeded]

turnvaccum timesalted room
[Mom going east]
[Mom going east - failed the can't go that way rule]

* * *

>E
[going east]

Small Hall
You can see a hall closet (closed) here.

[going east - succeeded]

turnno vacuume timeMom is wandering
[Mom going south]
[Mom going south - succeeded]

mom wandersactother numberlitwanderTeddy is wandering[Teddy going west - silently]
[Teddy going west - silently - succeeded]

>TKAE VACUUM
That's not a verb I recognise.

>OPEN CLOSET
[opening the hall closet]
You open the hall closet, revealing a vacuum cleaner.
[opening the hall closet - succeeded]

turnno vacuume timeMom is wandering
[Mom going north]
[Mom going north - succeeded]

mom wandersactother numberlitwanderTeddy is wandering[Teddy going south - silently]
[Teddy going south - silently - succeeded]

>TAKE VACUUM
[taking the vacuum cleaner]
Taken.
[taking the vacuum cleaner - succeeded]

turnno vacuume timeMom is wandering
[Mom going south]
[Mom going south - succeeded]

mom wanders

>E
[going east]

Living Room
[going east - succeeded]

turnno vacuume timeMom is wanderingmom wandersyourself

>E
[going east]

Laundry Room
You can see a dryer (closed) and a washer (closed) here.

[going east - succeeded]

turnno vacuume timeMom is wanderingmom wanders

>S
[going south]

Garage
[going south - succeeded]

turnno vacuume timeMom is wandering
[Mom going north]
[Mom going north - succeeded]

mom wanders

>POUR SALT ON GROUND
[salting the floor]
You pour the salt on the floor.
[salting the floor - succeeded]

turnvaccum timesalted room
[Mom going east]
[Mom going east - succeeded]

actother numberlitlightsgoout

>wait
[waiting]
Time passes.
[waiting - succeeded]

turnvaccum timesalted roomactother numberlitwanderTeddy is wandering[Teddy going west - silently]
[Teddy going west - silently - succeeded]

>wait
[waiting]
Time passes.
[waiting - succeeded]

turnvaccum timesearch timeMom: THERE'S the vacuum cleaner! How did it get out here?
Mom

>i
[taking inventory]
You are carrying:
  a vacuum cleaner
  a salt shaker

[taking inventory - succeeded]

turnvaccum timesearch timeMom: THERE'S the vacuum cleaner! How did it get out here?
Mom

* * *

>ACTIONS
Actions listing on.

>e
[going east]

Small Hall
You can see a hall closet (closed) here.

[going east - succeeded]

teddy is in the Your Bedroom

>e
[going east]

Living Room
[going east - succeeded]

teddy is in the Your Bedroom

>pour salt on ground
[salting the floor]
You pour the salt on the floor.
[salting the floor - succeeded]

turnvaccum timesalted room
[Mom going east]
[Mom going east - succeeded]

>wait
[waiting]
Time passes.
[waiting - succeeded]

turnvaccum timesalted room

>wait
[waiting]
Time passes.
[waiting - succeeded]

turnvaccum timesalted room
[Mom going east]
Mom arrives from the west.
[Mom going east - succeeded]

tryBRRRRRR!
Mom scolds you sternly for spilling salt on her floors, then vacuums up the mess.

>s
[going south]

entry hall
You can see Bobby here.

[going south - succeeded]

turnvaccum time
[Mom going west]
[Mom going west - succeeded]

>s
[going south]
You can't go that way.
[going south - failed the can't go that way rule]

turnno vacuume timeMom is wanderingmom wanders

>pour salt on ground
[salting the floor]
You pour the salt on the floor.
[salting the floor - succeeded]

turnvaccum timesalted room
[Mom going east]
[Mom going east - succeeded]

tryactother numberlitwanderTeddy is wandering[Teddy going west - silently]
[Teddy going west - silently - succeeded]

>wait
[waiting]
Time passes.
[waiting - succeeded]

turnvaccum timesalted room
[Mom going south]
Mom arrives from the north.
[Mom going south - succeeded]

tryBRRRRRR!
Mom scolds you sternly for spilling salt on her floors, then vacuums up the mess.

* * *

>e
[going east]

Living Room
[going east - succeeded]

teddy is in the Your Bedroom

>e
[going east]

Laundry Room
You can see a dryer and a washer here.

[going east - succeeded]

teddy is in the Your Bedroom

>open dryer
(the dryer)
[opening the dryer]
[(1) opening the dryer door]
You open the dryer door.
[(1) opening the dryer door - succeeded]

[opening the dryer - failed]

teddy is in the Your Bedroom

>put teddy in dryer
You can't see any such thing.

>put salt in dryer
(the dryer)
[inserting the salt shaker into the dryer]
[inserting the salt shaker into the dryer - failed]

teddy is in the Your Bedroom

>close dryer
(the dryer)
[closing the dryer]
[(1) closing the dryer door]
[(1) closing the dryer door - succeeded]

[closing the dryer - failed]

teddy is in the Your Bedroom

* * *

>e
[going east]

Small Hall
You can see a hall closet (closed) here.

[going east - succeeded]

teddy is in the Your Bedroom

>pour salt on ground
[salting the floor]
You pour the salt on the floor.
[salting the floor - succeeded]

turn

>e
[going east]

Living Room
[going east - succeeded]

turn

>s
[going south]

entry hall
You can see Bobby here.

[going south - succeeded]

turnactother numberlitwanderTeddy is wandering[Teddy going west - silently]
[Teddy going west - silently - succeeded]

>pour salt on ground
[salting the floor]
You pour the salt on the floor.
[salting the floor - succeeded]

turn

>n
[going north]

Living Room
[going north - succeeded]

turnactother numberlitlightsgoout

>n
[going north]

Kitchen
You can see a pantry (closed) here.

[going north - succeeded]

turn

>w
[going west]
You can't go that way.
[going west - failed the can't go that way rule]

turn

>e
[going east]

Dining Room
You can see a table and a high chair here.

[going east - succeeded]

turn

>e
[going east]
You can't go that way.
[going east - failed the can't go that way rule]

turn

* * *

>ACTIONS
Actions listing on.

>take coin
You can't see any such thing.

>take mom
[taking Mom]
I don't suppose Mom would care for that.
[taking Mom - failed the can't take other people rule]

yourself and Mom

* * *

>take coin
You can't see any such thing.

>take nothing
You can't see any such thing.

* * *

>ACTIONS
Actions listing on.

>TAKE CAKE
You can't see any such thing.

* * *

>ACTIONS
Actions listing on.

>drop salt
[dropping the salt shaker]
increase : 1[dropping the salt shaker - succeeded]

Your pockets suddenly feel lighter.
*** Couldn't read from entry 3 of a list which has only one entry, numbered 1 ***

*** Run-time problem P50: Attempt to use list item which does not exist.

testyourself, Mom and coin

* * *

>ACTIONS
Actions listing on.

>TAKE TEDDY
[taking Teddy]
Taken.
[taking Teddy - succeeded]

teddy is in the Your Bedroom

>W
[going west]
You can't go that way.
[going west - failed the can't go that way rule]

teddy is in the Your Bedroom

>E
[going east]

Small Hall
You can see a hall closet (closed) here.

[going east - succeeded]

teddy is in the Small Hall

>E
[going east]

Living Room
[going east - succeeded]

teddy is in the Living Room

>E
[going east]

Laundry Room
You can see a dryer (closed) and a washer (closed) here.

[going east - succeeded]

teddy is in the Laundry Room

>PUT TEDDY IN WASHER
[inserting Teddy into the washer]
The washer is closed.
[inserting Teddy into the washer - failed the can't insert into closed containers rule]

teddy is in the Laundry Room

>OPEN WASHER
[opening the washer]
You open the washer.
[opening the washer - succeeded]

teddy is in the Laundry Room

>PUT TEDDY IN WASHER
[inserting Teddy into the washer]
You put Teddy into the washer.
[inserting Teddy into the washer - succeeded]

teddy is in the Laundry Room

>CLOSE WASHER
[closing the washer]
[closing the washer - succeeded]

teddy is in nothing

>examine dryer
[examining the dryer]
You see nothing special about the dryer.

[examining the dryer - succeeded]

teddy is in nothing

>open dryer
[opening the dryer]
You open the dryer.
[opening the dryer - succeeded]

teddy is in nothing

>close dryer
[closing the dryer]
[closing the dryer - succeeded]

teddy is in nothing

>wait
[waiting]
Time passes.
[waiting - succeeded]

teddy is in nothing

>wait
[waiting]
Time passes.
[waiting - succeeded]

teddy is in nothing

>wait
[waiting]
Time passes.
[waiting - succeeded]

[the coin going south]
[the coin going south - succeeded]

teddy is in nothing

>wait
[waiting]
Time passes.
[waiting - succeeded]

teddy is in nothing

>wait
[waiting]
Time passes.
[waiting - succeeded]

teddy is in nothing
"Click-click-click bang!"

You hear the sound of something breaking.

>wait
[waiting]
Time passes.
[waiting - succeeded]

teddy is in the Laundry Room

>examine washer
[examining the washer]
You see nothing special about the washer.

[examining the washer - succeeded]

teddy is in the Laundry Room

>examine dryer
[examining the dryer]
You see nothing special about the dryer.

[examining the dryer - succeeded]

teddy is in the Laundry Room

* * *

>ACTIONS
Actions listing on.

>WEAR lucky boxers
[wearing the lucky boxers]
You put on the lucky boxers.
[wearing the lucky boxers - succeeded]

teddy is in the Your Bedroom

>take off lucky boxers
[taking off the lucky boxers]
You take off the lucky boxers.
[taking off the lucky boxers - succeeded]

teddy is in the Your Bedroom

* * *

>ACTIONS
Actions listing on.

>push dresser
[pushing the dresser]
It is fixed in place.
[pushing the dresser - failed the can't push what's fixed in place rule]

teddy is in the Your Bedroom

* * *

>ACTIONS
Actions listing on.

>pour salt on teddy
[pouring the salt shaker]
You pour some salt on Teddy
Teddy shrieks and bites into your arm with a dozen needle-sharp teeth. You drop the bear and the salt shaker, spilling the remainder of its contents. When you look up from your wound, you notice that Teddy is nowhere to be seen.
yourself seems to be oblivious to your struggle[pouring the salt shaker - succeeded]

mom is light-policing 
mom is locating salt 
mom sees the salt in Your Bedroom
mom is vacuum-fetching
mom is fetching the vacuum 

[Mom going east]
Mom goes east.
[Mom going east - succeeded]

[a salty nothing going east - silently]
[a salty nothing going east - silently - succeeded]

teddy is in the Small Hall

* * *

>ACTIONS
Actions listing on.

>wear boxers
[wearing the lucky boxers]
You put on your lucky boxers. What were you wearing before? luck: 3
[wearing the lucky boxers - succeeded]

teddy is in the Your Bedroom

>take off boxers
[taking off the lucky boxers]
luck: 1
[taking off the lucky boxers - succeeded]

teddy is in the Your Bedroom

* * *

>ACTIONS
Actions listing on.

>S
[going south]

Shared Bathroom
I share this bathroom with my brother, Bobby.

You can see Chaser and a mirror here.

[going south - succeeded]

The family dog, chaser, bounds up to you with a rubber ball in his mouth.

[Chaser dropping the rubber ball]
Chaser puts down the rubber ball.
[Chaser dropping the rubber ball - succeeded]

He looks up at you expectantly, his tail wagging.
teddy is in the Your Bedroom

* * *

>ask mom about salt
There is no reply.

>ACTIONS
Actions listing on.

>ask mom about salt
[asking Mom about "salt"]
There is no reply.
[asking Mom about "salt" - succeeded]

* * *

>wai
That's not a verb I recognise.

>wait
Time passes.

* * *

>wait
Time passes.

DEBUG: dadvision is empty
DEBUG: dad looking for thingsmom is light-policing 
mom is locating salt 

DEBUG: Mom wanders to the Small Hall
DEBUG: Teddy's is deciding
 DEBUG: teddy is in the Your Bedroom

>look
My Bedroom
This is my bedroom. There is a shelf with  a teddy bear on it. 

You can see Mom and a salt here.

"Click."
It is now pitch dark in here!

>turn on lights
"Click."
My Bedroom
This is my bedroom. There is a shelf with  a teddy bear on it. 

You can see Mom and a salt here.

>i
You are carrying nothing.

* * *

>wait
Time passes.

>wait
Time passes.

"Click."
It is now pitch dark in here!

>wait
Time passes.

* * *

>i
You are carrying nothing.

>look
Darkness
It is pitch dark, and you can't see a thing.

>i
You are carrying nothing.

* * *

>wait
Time passes.

DEBUG: dadvision is empty
DEBUG: dad looking for thingsmom is light-policing 
mom is locating salt 

DEBUG: Mom wanders to the Small Hall
DEBUG: Teddy's is deciding
 DEBUG: teddy is in the Your Bedroom

>wait
Time passes.

DEBUG: dadvision is empty
DEBUG: dad looking for things
DEBUG: Teddy's is deciding
 DEBUG: teddy is in the Your Bedroom

>wait
Time passes.

mom is light-policing 
mom is locating salt 
teddy is in the Your Bedroom

>wait
Time passes.

successteddy is in the Your Bedroom

>wait
Time passes.

successteddy is in the Your Bedroom

>l
My Bedroom
This is my bedroom. There is a shelf with  a teddy bear on it. 

You can see Mom, a kiddie stool and a salt here.

* * *

>wait
Time passes.

>l
My Bedroom
This is my bedroom. There is a shelf with  a teddy bear on it. 

You can see Mom, a kiddie stool and a salt here.

>l
My Bedroom
This is my bedroom. There is a shelf with  a teddy bear on it. 

You can see Mom, a kiddie stool and a salt here.

* * *

>wait
Time passes.

>look
My Bedroom
This is my bedroom. There is a shelf with  a teddy bear on it. 

You can see Mom, a kiddie stool and a salt here.

* * *

>wait
Time passes.

successteddy is in the Your Bedroom

>wait
Time passes.

yourself and Mom

>wait
Time passes.

yourself

* * *

>wait
Time passes.

yourselfactyou alonelitnot carried

>wait
Time passes.

yourself and Mom

>look
My Bedroom
This is my bedroom. There is a shelf with nothing on it.

You can see Mom, a kiddie stool and a salt here.

>i
You are carrying:
  Teddy

"Click." The lights go off.

It is now pitch dark in here!

>wait
Time passes.

* * *

>wait
Time passes.

yourself and Mom

>l
My Bedroom
This is my bedroom. There is a shelf with  a teddy bear on it. 

You can see Mom, a kiddie stool, a my bed and a dresser here.

yourself and Mom

>wait
Time passes.

yourself and Momacttwolitnot carried

>wait
Time passes.

yourself and Mom

>l
Darkness
It is pitch dark, and you can't see a thing.

>get on stool
You get onto the kiddie stool.

>turn on lights
"Click." The lights go on.

"Click." The lights go off.

>turn on lights
"Click." The lights go on.

My Bedroom (on the kiddie stool)
This is my bedroom. There is a shelf with nothing on it.

You can see Mom and a salt here.

* * *

>wait
Time passes.

yourself and Mom

>drop teddy
Dropped.

yourself and Mom

* * *

>wait
Time passes.

yourselfactyou alonelitnot carried

>s
Shared Bathroom
I share this bathroom with my brother, Bobby.

You can see a mirror here.

* * *

>wait
Time passes.

>n
Darkness
It is pitch dark, and you can't see a thing.

>wait
Time passes.

>look
My Bedroom (on the kiddie stool)
This is my bedroom. There is a shelf with nothing on it.

You can see a salt here.

>wait
Time passes.

>lok
That's not a verb I recognise.

>look
My Bedroom (on the kiddie stool)
This is my bedroom. There is a shelf with nothing on it.

You can see a salt here.

>s
(first getting off the kiddie stool)

Darkness
It is pitch dark, and you can't see a thing.

>n
My Bedroom
This is my bedroom. There is a shelf with  a teddy bear on it. 

You can see a kiddie stool and a salt here.

>push stool south
You push the kiddie stool south to the Shared Bathroom.

Darkness
It is pitch dark, and you can't see a thing.

* * *

>wait
Time passes.

yourself

>undo
My Bedroom
[Previous turn undone.]

>undo
My Bedroom
[Previous turn undone.]

>duno
That's not a verb I recognise.

>undo
My Bedroom
[Previous turn undone.]

>l
My Bedroom
This is my bedroom. There is a shelf with  a teddy bear on it. 

You can see Mom, a kiddie stool, a my bed and a dresser here.

yourself and Mom

>wait
Time passes.

yourself and Mom

>wait
Time passes.

yourselfactyou alonelitnot carried

* * *

>wait
Time passes.

successteddy is in the Your Bedroom

>i
You are carrying:
  a salt shaker

yourself and Mom

>wait
Time passes.

yourselfactyou alonedarkcarried

    *** Teddy got you. ***

Would you like to RESTART, RESTORE a saved game, QUIT or UNDO the last command?

>restart
Bad Teddy
An Interactive Fiction by "Y'Gael of Atrii" this is a subtitle
Release 1 / Serial number 201215 / Inform 7 build 6M62 (I6/v6.33 lib 6/12N) SD

My Bedroom
This is my bedroom. There is a shelf with  a teddy bear on it. 

You can see Mom, a kiddie stool and a salt here.

>s
Shared Bathroom
I share this bathroom with my brother, Bobby.

You can see a mirror here.

Momactother alonelit"Click." The lights go off.

>wait
Time passes.

Momactother alonedark

>wait
Time passes.

actother number

* * *

>i
You are carrying:
  a salt shaker

yourself and Mom

>l
Your Bedroom
This is your bedroom. There is a shelf with  a teddy bear on it. 

You can see Mom, a kiddie stool, your bed and a dresser here.

yourself and Mom

>wait
Time passes.

yourself and Mom

>dwait
That's not a verb I recognise.

* * *

>wait
Time passes.

successteddy is in the Your Bedroom

>undo
My Bedroom
[Previous turn undone.]

>wait
Time passes.

Mom and yourself
Mom goes south.

to saltShared Bathroom0 You hear the whirring of the vacuum cleaner some distance awayShared Bathroom

>s
Shared Bathroom
I share this bathroom with my brother, Bobby.

You can see Mom and a mirror here.

Mom goes north.

going back

>l
Shared Bathroom
I share this bathroom with my brother, Bobby.

You can see Mom and a mirror here.

yourself and Mom

>wait
Time passes.

yourself and Mom

* * *

>s
Shared Bathroom
I share this bathroom with my brother, Bobby.

You can see Mom and a mirror here.

Mom goes north.

going back

>wait
Time passes.

Mom
going back

>wait
Time passes.

vacuum back

>wait
Time passes.

* * *

>wait
Time passes.

successteddy is in the Your Bedroom

>push stool s
Pushing the kiddie stool is difficult and noisy. Time passes.

You push the kiddie stool south to the Shared Bathroom.

increase : 1
Mom

>turn off lights
You're too small to reach it.

Mom

>get on stool
You get onto the kiddie stool.

Mom and yourself

>turn off lights
Mom and yourself
0
It is now pitch dark in here!

* * *

>wait
Time passes.

mom is light-policing 
mom is locating salt 
teddy is in the Your Bedroom

>turn on light
"Click."
My Bedroom
This is my bedroom. There is a shelf with nothing on it.

You can see Mom, a kiddie stool and a salt here.

* * *

>wait
Time passes.

mom is light-policing 
mom is locating salt 
teddy is in the Your Bedroom

>take teddy
Taken.

yourself and Momyourself and Mom

>wait
Time passes.

yourself and Momyourself and Mom

* * *

>wait
Time passes.

DEBUG: dadvision is empty
DEBUG: dad looking for things
DEBUG: Teddy's is deciding
 DEBUG: teddy is in the Your Bedroom

>i
You are carrying nothing.

Your pockets suddenly feel lighter.
yourself, Mom and coin

>i
You are carrying nothing.

>i
You are carrying nothing.

"Click."
It is now pitch dark in here!

>get on stool
You get onto the kiddie stool.

>turn on lights
My Bedroom (on the kiddie stool)
This is my bedroom. There is a shelf with  a teddy bear on it. 

You can see a salt here.

>wait
Time passes.

* * *

>i
You are carrying nothing.

>i
You are carrying nothing.

It is now pitch dark in here!

>i
You are carrying nothing.

>l
Darkness
It is pitch dark, and you can't see a thing.

>turn on lights
My Bedroom (on the kiddie stool)
This is my bedroom. There is a shelf with  a teddy bear on it. 

You can see a salt here.

>l
My Bedroom (on the kiddie stool)
This is my bedroom. There is a shelf with  a teddy bear on it. 

You can see a salt here.

>l
My Bedroom (on the kiddie stool)
This is my bedroom. There is a shelf with  a teddy bear on it. 

You can see a salt here.

It is now pitch dark in here!

>turn on lights
My Bedroom (on the kiddie stool)
This is my bedroom. There is a shelf with  a teddy bear on it. 

You can see a salt here.

>i
You are carrying nothing.

* * *

>i
You are carrying nothing.

Your pockets suddenly feel lighter.
yourself, Mom and coin

>s
Shared Bathroom
I share this bathroom with my brother, Bobby.

You can see a mirror here.

* * *

>wait
Time passes.

>n
Darkness
It is pitch dark, and you can't see a thing.

    *** Teddy got you. ***

Would you like to RESTART, RESTORE a saved game, QUIT or UNDO the last command?

* * *

>i
You are carrying nothing.

Your pockets suddenly feel lighter.
yourself, Mom and coin

>wait
Time passes.

yourself

>wait
Time passes.

yourselfactyou alonedarkcarried

    *** Teddy got you. ***

Would you like to RESTART, RESTORE a saved game, QUIT or UNDO the last command?

* * *

>wait
Time passes.

DEBUG: dadvision is empty
DEBUG: dad looking for things
DEBUG: Teddy's is deciding
 DEBUG: teddy is in the Your Bedroom

>turn on lights
You're too small to reach it.

>get on stool
You get onto the kiddie stool.

>turn on lights
"Click." The lights go on.

My Bedroom (on the kiddie stool)
This is my bedroom. There is a shelf with  a teddy bear on it. 

You can see Mom and a salt here.

>wait
Time passes.

>wait
Time passes.

act

>wait
Time passes.

act"Click." The lights go off.

It is now pitch dark in here!

>turn on lights
"Click." The lights go on.

act"Click." The lights go off.

>wait
Time passes.

act

>wait
Time passes.

* * *

>wait
Time passes.

act

>i
You are carrying nothing.

>l
Darkness
It is pitch dark, and you can't see a thing.

act

>turn on lights
"Click." The lights go on.

act"Click." The lights go off.

>i
You are carrying nothing.

act

I beg your pardon?

>i
You are carrying nothing.

>i
You are carrying nothing.

act

>i
You are carrying nothing.

act

* * *

>wait
Time passes.

DEBUG: dadvision is empty
DEBUG: dad looking for things
DEBUG: Teddy's is deciding
 DEBUG: teddy is in the Your Bedroom

>e
Small Hall
You can see Mom and a hall closet (closed) here.

>wait
Time passes.

>wait
Time passes.

actother numberlitwander

>l
Darkness
It is pitch dark, and you can't see a thing.

actother numberlitlightsgoout
to saltShared Bathroom

>undo
Darkness
[Previous turn undone.]

>undo
My Bedroom
[Previous turn undone.]

>l
My Bedroom
This is my bedroom. There is a shelf with  a teddy bear on it. 

You can see Mom, a kiddie stool, a my bed and a dresser here.

yourself and Momacttwolitnot carried
Mom goes east.

try

>e
Small Hall
You can see Mom and a hall closet (closed) here.

yourself and MomMom retrieves the vacuum from the cabinet

>wait
Time passes.

yourself and Mom
Mom goes south.

to saltShared Bathroom

>s
Bobby's Bedroom
You can see Mom and a toybox (closed) here.

yourself and Mom
to saltShared Bathroom

>wait
Time passes.

yourself and Momacttwolitcarried"Click." 
The lights go off.
lightsgoout
to saltShared Bathroom
It is now pitch dark in here!

>undo
Bobby's Bedroom
[Previous turn undone.]

>look
Bobby's Bedroom
You can see Mom and a toybox (closed) here.

yourself and Mom
to saltShared Bathroom

>look
Bobby's Bedroom
You can see Mom and a toybox (closed) here.

yourself and Mom
to saltShared Bathroom

* * *

>wait
Time passes.

actother numberlitwander

>wait
Time passes.

>wait
Time passes.

Mom retrieves the vacuum from the cabinet

>wait
Time passes.

Mom goes west.

You hear the whirring of a vacuum cleaner some distance away.
actother numberlitwander

>w
My Bedroom
This is my bedroom. There is a shelf with  a teddy bear on it. 

You can see Mom, a kiddie stool, a my bed and a dresser here.

yourself and Mom

>wait
Time passes.

yourself and Mom

>wait
Time passes.

Mom goes east.

yourself

>e
Small Hall
You can see Mom and a hall closet (closed) here.

>wait
Time passes.

Mom puts the vacuum back in the hall closet

>wait
Time passes.

>l
Small Hall
You can see Mom and a hall closet (closed) here.

* * *

>wait
Time passes.

DEBUG: dadvision is empty
DEBUG: dad looking for things
DEBUG: Teddy's is deciding
 DEBUG: teddy is in the Your Bedroom

>s
Shared Bathroom
I share this bathroom with my brother, Bobby.

You can see a mirror here.

to saltShared Bathroom1

>wait
Time passes.

Mom
Mom arrives from the north.

to saltShared Bathroom0 unsalted

>wait
Time passes.

* * *

>wait
Time passes.

DEBUG: dadvision is empty
DEBUG: dad looking for things
DEBUG: Teddy's is deciding
 DEBUG: teddy is in the Your Bedroom

>pour salt on floor
You pour the salt on the floor.

>wait
Time passes.

Mom goes east.

>wait
Time passes.

>wait
Time passes.

actother numberlitlightsgoout
It is now pitch dark in here!

>get on stool
You get onto the kiddie stool.

yourselfactyou alonelitnot carried

>turn on lights
"Click." 
The lights go on.

yourself
My Bedroom (on the kiddie stool)
This is my bedroom. There is a shelf with nothing on it.

You can see a my bed and a dresser here.

>wait
Time passes.

Mom goes west.

BRRRRRR!
Mom scolds you sternly for spilling salt on her floors, then vacuums up the mess.
Mom and yourself

>l
My Bedroom (on the kiddie stool)
This is my bedroom. There is a shelf with nothing on it.

You can see Mom, a my bed and a dresser here.

Mom and yourself

>wait
Time passes.

Mom and yourself

>wait
Time passes.

Mom goes east.

yourself

>wait
Time passes.

yourself

>e
(first getting off the kiddie stool)

Small Hall
You can see Mom and a hall closet (closed) here.

Mom puts the vacuum back in the hall closet

>e
Living Room

* * *

>e
Laundry Room
You can see a dryer (closed) and a washer (closed) here.

>e
You can't go that way.

>pour salt on floor
You pour the salt on the floor.

>wait
Time passes.

* * *

>wait
Time passes.

actother numberlitwander

>wait
Time passes.

Bobby

>wait
Time passes.

Bobby

>wait
Time passes.

Bobbyactother alonelitlightsgoout
It is now pitch dark in here!

>l
Darkness
It is pitch dark, and you can't see a thing.

Bobby

>wait
Time passes.

Bobbyactother alonelitlightsgoout

* * *

>wait
Time passes.

DEBUG: dadvision is empty
DEBUG: dad looking for things
DEBUG: Teddy's is deciding
 DEBUG: teddy is in the Your Bedroom

>undo
Your Bedroom
[Previous turn undone.]

>wait
Time passes.

yourself, Mom and coin

>s
Shared Bathroom
I share this bathroom with my brother, Bobby.

You can see a mirror here.

The coin arrives from the north.

Mom

>wait
Time passes.

Mom

>n
Your Bedroom
This is your bedroom. There is a shelf with  a teddy bear on it. 

You can see Mom, a kiddie stool, your bed and a dresser here.

yourself and Mom

>s
Shared Bathroom
I share this bathroom with my brother, Bobby.

You can see a mirror and a mirror here.

Mom

>take mirror
Taken.

Your pockets suddenly feel lighter.
Mom

* * *

>wait
Time passes.

DEBUG: dadvision is empty
DEBUG: dad looking for thingsmom is light-policing 
mom is locating salt 

DEBUG: Mom wanders to the Small Hall
DEBUG: Teddy's is deciding
 DEBUG: teddy is in the Your Bedroom

>get in stool
You get onto the kiddie stool.

>turn on lights
My Bedroom (on the kiddie stool)
This is my bedroom. There is a shelf with  a teddy bear on it. 

You can see a salt here.

>wait
Time passes.

It is now pitch dark in here!

* * *

>i
You are carrying nothing.

It is now pitch dark in here!

>turn on lights
My Bedroom (on the kiddie stool)
This is my bedroom. There is a shelf with  a teddy bear on it. 

You can see a salt here.

* * *

>wait
Time passes.

It is now pitch dark in here!

>wait
Time passes.

* * *

>wait
Time passes.

DEBUG: dadvision is empty
DEBUG: dad looking for thingsmom is light-policing 
mom is locating salt 

DEBUG: Mom wanders to the Small Hall
DEBUG: Teddy's is deciding
 DEBUG: teddy is in the Your Bedroom

>turn on lights
You're too small to reach it.

yourself, Mom and coin

>get on stool
You get onto the kiddie stool.

* * *

>wait
Time passes.

DEBUG: dadvision is empty
DEBUG: dad looking for thingsmom is light-policing 
mom is locating salt 

DEBUG: Mom wanders to the Small Hall
DEBUG: Teddy's is deciding
 DEBUG: teddy is in the Your Bedroom

>l
Your Bedroom
This is your bedroom. There is a shelf with a teddy bear on it. 

You can see a hamper (empty), a step stool, dad, your bed and a dresser here.

DEBUG: dadvision is empty
DEBUG: dad looking for things
DEBUG: dad is chasingDEBUG: Chaser is wandering to the shared bathroommom is light-policing 
mom is locating salt 

DEBUG: Mom wanders to the Play Room
DEBUG: Teddy's is deciding 
DEBUG: teddy acts"Click." 
The lights go off.

 DEBUG: teddy is in the Your Bedroom
It is now pitch dark in here!

>i
You are carrying nothing.

* * *

>l
Your Bedroom
This is your bedroom. There is a shelf with a teddy bear on it. 

You can see a hamper (empty), a step stool, dad, your bed and a dresser here.

DEBUG: dadvision is empty
DEBUG: dad looking for things
DEBUG: dad is chasingDEBUG: Chaser is wandering to the shared bathroommom is light-policing 
mom is locating salt 

DEBUG: Mom wanders to the Play Room
DEBUG: Teddy's is deciding 
DEBUG: teddy acts"Click." 
The lights go off.

 DEBUG: teddy is in the Your Bedroom
It is now pitch dark in here!

>l
Your Bedroom
This is your bedroom. There is a shelf with nothing on it.

You can see Mom, a kiddie stool, your bed, a dresser and a coin here.

>l
Your Bedroom
This is your bedroom. There is a shelf with nothing on it.

You can see Mom, a kiddie stool, your bed, a dresser and a coin here.

actother numberlitwander

>l
Your Bedroom
This is your bedroom. There is a shelf with  a teddy bear on it. 

You can see Mom, a kiddie stool, your bed, a dresser and a coin here.

yourself, Mom and coin

>l
Your Bedroom
This is your bedroom. There is a shelf with  a teddy bear on it. 

You can see Mom, a kiddie stool, your bed, a dresser and a coin here.

yourself, Mom and coin

* * *

>wait
Time passes.

DEBUG: dadvision is empty
DEBUG: dad looking for thingsmom is light-policing 
mom is locating salt 

DEBUG: Mom wanders to the Small Hall
DEBUG: Teddy's is deciding
 DEBUG: teddy is in the Your Bedroom

>get on stool
You get onto the kiddie stool.

yourselfacthere

>turn on lights
"Click." The lights go on.

"Click." The lights go off.

>wait
Time passes.

* * *

>wait
Time passes.

DEBUG: dadvision is empty
DEBUG: dad looking for thingsmom is light-policing 
mom is locating salt 

DEBUG: Mom wanders to the Small Hall
DEBUG: Teddy's is deciding
 DEBUG: teddy is in the Your Bedroom

>take teddy
Taken.

yourself and Mom

>wait
Time passes.

yourself and Mom

>l
Your Bedroom
This is your bedroom. There is a shelf with nothing on it.

You can see Mom, a kiddie stool, your bed and a dresser here.

yourself and MomacttwolitcarriedThe lights are already off.
lightsgoout

* * *

>wait
Time passes.

DEBUG: dadvision is empty
DEBUG: dad looking for thingsmom is light-policing 
mom is locating salt 

DEBUG: Mom wanders to the Small Hall
DEBUG: Teddy's is deciding
 DEBUG: teddy is in the Your Bedroom

>i
You are carrying:
  a salt shaker
  your lucky boxers

>wait
Time passes.

yourself and Momacttwolitnot carried"Click." 
The lights go off.
lightsgoout
It is now pitch dark in here!

>wait
Time passes.

yourself and Mom

>wait
Time passes.

yourself and Momacttwolitcarried"Click." The lights go off.

It is now pitch dark in here!

>wait
Time passes.

yourself and Momacttwodarkcarried

    *** Teddy got you. ***

Would you like to RESTART, RESTORE a saved game, QUIT or UNDO the last command?

* * *

>wait
Time passes.

yourself and Momacttwolitnot carried"Click." 
The lights go off.
lightsgoout
It is now pitch dark in here!

>s
Shared Bathroom
I share this bathroom with my brother, Bobby.

You can see a mirror and a mirror here.

Mom

>wait
Time passes.

The yourself goes north.

yourself and Momacttwodarknot carried

>i
You are carrying nothing.

* * *

>i
You are carrying:
  a salt shaker
  your lucky boxers

>undo
Your Bedroom
[Previous turn undone.]

>undo
Your Bedroom
[Previous turn undone.]

>wait
Time passes.

Your pockets suddenly feel lighter.
yourself, Mom and coin

>l
Your Bedroom
This is your bedroom. There is a shelf with  a teddy bear on it. 

You can see Mom, a kiddie stool, your bed, a dresser and a coin here.

yourself, Mom and coin

>l
Your Bedroom
This is your bedroom. There is a shelf with  a teddy bear on it. 

You can see Mom, a kiddie stool, your bed, a dresser and a coin here.

yourself, Mom and coinactother numberlitlightsgoout"Click." 
The lights go off.

It is now pitch dark in here!

>undo
Your Bedroom
[Previous turn undone.]

>l
Your Bedroom
This is your bedroom. There is a shelf with  a teddy bear on it. 

You can see Mom, a kiddie stool, your bed, a dresser and a coin here.

yourself, Mom and coin

>s
Shared Bathroom
I share this bathroom with my brother, Bobby.

You can see a mirror here.

The dresser arrives from the north.

Mom

* * *

>wait
Time passes.

DEBUG: dadvision is empty
DEBUG: dad looking for thingsmom is light-policing 
mom is locating salt 

DEBUG: Mom wanders to the Small Hall
DEBUG: Teddy's is deciding
 DEBUG: teddy is in the Your Bedroom

>s
shared bathroom
I share this bathroom with my brother, Bobby.

You can see Chaser and a mirror here.

Chaser bounds up to you with a rubber ball in his mouth.

Chaser puts down the rubber ball.

He looks up at you expectantly, tail wagging.

DEBUG: dadvision is empty
DEBUG: dad looking for things
DEBUG: Teddy's is deciding
 DEBUG: teddy is in the Your Bedroom

>wait
Time passes.

The light switch goes north.

light switch and Mom

>wait
Time passes.

yourself

>drop teddy
Dropped.

yourself

>n
My Bedroom
This is my bedroom. There is a shelf with nothing on it.

You can see Mom, a kiddie stool and a salt here.

>wait
Time passes.

actother numberdarkchase

>wait
Time passes.

yourself and Mom

>wait
Time passes.

yourself and Momacttwolitnot carried"Click." The lights go off.

It is now pitch dark in here!

>i
You are carrying nothing.

yourself and Momacttwodarknot carried

>wait
Time passes.

yourself

>wait
Time passes.

yourselfactyou alonedarknot carried

>i
You are carrying:
  Teddy

yourselfactyou alonedarkcarried

    *** Teddy got you. ***

Would you like to RESTART, RESTORE a saved game, QUIT or UNDO the last command?

* * *

>wait
Time passes.

The light switch goes north.

light switch and Mom

>n
Your Bedroom
This is your bedroom. There is a shelf with  a teddy bear on it. 

You can see a light switch, Mom, a kiddie stool, your bed and a dresser here.

The floor goes east.

yourself and Mom

>i
You are carrying nothing.

yourself and Mom

* * *

>s
shared bathroom
I share this bathroom with my brother, Bobby.

You can see Chaser and a mirror here.

Chaser bounds up to you with a rubber ball in his mouth.

Chaser puts down the rubber ball.

He looks up at you expectantly, tail wagging.

DEBUG: dadvision is empty
DEBUG: dad looking for things
DEBUG: Teddy's is deciding
 DEBUG: teddy is in the Your Bedroom

>n
Your Bedroom
This is your bedroom. There is a shelf with  a teddy bear on it. 

You can see Mom, a kiddie stool, your bed, a dresser and a kiddie stool here.

yourself, Mom and kiddie stool

>e
Small Hall
You can see a hall closet (closed) here.

yourself
Shared Bathroom

>wait
Time passes.

yourself
Shared Bathroom

* * *

>n
Your Bedroom
This is your bedroom. There is a shelf with  a teddy bear on it. 

You can see Mom, a kiddie stool, your bed, a dresser and a kiddie stool here.

yourself, Mom and kiddie stool

>s
Shared Bathroom
I share this bathroom with my brother, Bobby.

You can see a mirror here.

Mom and kiddie stool

>n
Your Bedroom
This is your bedroom. There is a shelf with  a teddy bear on it. 

You can see Mom, a kiddie stool, your bed, a dresser and a kiddie stool here.

yourself, Mom and kiddie stool

>n
You can't go that way.

yourself, Mom and kiddie stool

>s
Shared Bathroom
I share this bathroom with my brother, Bobby.

You can see a mirror here.

Mom and your bed

>n
Your Bedroom
This is your bedroom. There is a shelf with  a teddy bear on it. 

You can see Mom, a kiddie stool, your bed, a dresser and a your bed here.

yourself, Mom and your bed

>s
Shared Bathroom
I share this bathroom with my brother, Bobby.

You can see a mirror here.

Mom and Teddyacttwolitnot carried

>wait
Time passes.

yourself

>n
Your Bedroom
This is your bedroom. There is a shelf with nothing on it.

You can see Mom, a kiddie stool, your bed, a dresser and a dresser here.

Your pockets suddenly feel lighter.
yourself, Mom and dresser

* * *

>s
shared bathroom
I share this bathroom with my brother, Bobby.

You can see Chaser and a mirror here.

Chaser bounds up to you with a rubber ball in his mouth.

Chaser puts down the rubber ball.

He looks up at you expectantly, tail wagging.

DEBUG: dadvision is empty
DEBUG: dad looking for things
DEBUG: Teddy's is deciding
 DEBUG: teddy is in the Your Bedroom

>l
Shared Bathroom
I share this bathroom with my brother, Bobby.

You can see Mom and a mirror here.

teddy is in the Your Bedroom

* * *

>s
shared bathroom
I share this bathroom with my brother, Bobby.

You can see Chaser and a mirror here.

Chaser bounds up to you with a rubber ball in his mouth.

Chaser puts down the rubber ball.

He looks up at you expectantly, tail wagging.

DEBUG: dadvision is empty
DEBUG: dad looking for things
DEBUG: Teddy's is deciding
 DEBUG: teddy is in the Your Bedroom

>take ball
Taken.

DEBUG: dadvision is empty
DEBUG: dad looking for thingsDEBUG: Chaser is wandering to the Small Hallmom is light-policing 
mom is locating salt 

DEBUG: Mom wanders to the Your Bedroom
DEBUG: Teddy's is deciding
 DEBUG: teddy is in the Your Bedroom

>n
Your Bedroom
This is your bedroom. There is a shelf with a teddy bear on it. 

You can see Mom, a hamper (in which is your lucky boxers), a dog bed, dad, a widget, your bed and a dresser here.

DEBUG: dadvision is empty
DEBUG: dad looking for thingsmom is light-policing 
mom is locating salt 

Mom goes east.

DEBUG: Mom wanders to the Small Hall
DEBUG: Teddy's is deciding
 DEBUG: teddy is in the Your Bedroom

>drop ball
DEBUG: Teddy heard you
Dropped.

DEBUG: dadvision is empty
DEBUG: dad looking for things
DEBUG:adding rubber ball to dadvision
DEBUG: the stating position of rubber ball is the shared bathroom
Dad picks up the rubber ball.

Dad goes south.

DEBUG: dad is chasing

DEBUG: Teddy's is deciding
 DEBUG: teddy is in the Your Bedroom

>s
shared bathroom
I share this bathroom with my brother, Bobby.

You can see dad and a mirror here.

DEBUG: dadvision is empty
DEBUG: dad looking for things
DEBUG: dad is chasing

DEBUG: Teddy's is deciding
 DEBUG: teddy is in the Your Bedroom

* * *

>wait
Time passes.

DEBUG: dadvision is empty
DEBUG: dad looking for thingsmom is light-policing 
mom is locating salt 

DEBUG: Mom wanders to the Small Hall
DEBUG: Teddy's is deciding
 DEBUG: teddy is in the Your Bedroom

>e
Small Hall
You can see Mom and a hall closet (closed) here.

yourself and MomMom retrieves the vacuum from the cabinet

>wait
Time passes.

yourself and Mom
Mom goes west.

to saltShared Bathroom1

>s
Bobbys
You can see Mom and a toybox (closed) here.

to saltShared Bathroom1

>wait
Time passes.

to saltShared Bathroom1

>undo
Bobby's Bedroom
[Previous turn undone.]

>wait
Time passes.

yourself and Mom
Shared Bathroom

* * *

>wait
Time passes.

to saltShared Bathroom1

>wait
Time passes.

to saltShared Bathroom1

>ss
That's not a verb I recognise.

>s
You can't go that way.

actother numberlitlightsgoout
It is now pitch dark in here!

>n
Small Hall
You can see a hall closet (closed) here.

>w
My Bedroom
This is my bedroom. There is a shelf with  a teddy bear on it. 

You can see a kiddie stool, a my bed and a dresser here.

yourself

>w
You can't go that way.

yourself

>e
Small Hall
You can see a hall closet (closed) here.

>w
My Bedroom
This is my bedroom. There is a shelf with  a teddy bear on it. 

You can see a kiddie stool, a my bed and a dresser here.

yourself

>n
You can't go that way.

yourself

>s
Shared Bathroom
I share this bathroom with my brother, Bobby.

You can see a roomba and a mirror here.

>s
You can't go that way.

* * *

>undo
Bobby's Bedroom
[Previous turn undone.]

>wait
Time passes.

yourself and Mom
to salt

* * *

>wait
Time passes.

to saltShared Bathroom1

>wait
Time passes.

to salt

* * *

>wait
Time passes.

to saltShared Bathroom1

>e
You can't go that way.

to saltShared Bathroom1

>w
Shared Bathroom
I share this bathroom with my brother, Bobby.

You can see a mirror here.

to saltShared Bathroom1

>e
Bobby's Bedroom
You can see Mom and a toybox (closed) here.

to saltShared Bathroom1

>e
You can't go that way.

to saltShared Bathroom1

>ACTIONS
Actions listing on.

>WAIT
[waiting]
Time passes.
[waiting - succeeded]

[Mom going south]
[Mom going south - failed the can't go that way rule]

to saltShared Bathroom1

>e
[going east]
You can't go that way.
[going east - failed the can't go that way rule]

[Mom going south]
[Mom going south - failed the can't go that way rule]

to saltShared Bathroom1

>w
[going west]

Shared Bathroom
I share this bathroom with my brother, Bobby.

You can see a mirror here.

[going west - succeeded]

[Mom going south]
[Mom going south - failed the can't go that way rule]

to saltShared Bathroom1

* * *

>wait
Time passes.

to saltShared Bathroom1

>ACTIONS
Actions listing on.

* * *

>wait
Time passes.

to saltShared Bathroom1

>l
Bobby's Bedroom
You can see Mom and a toybox (closed) here.

actother numberlitwander
to salt

>wait
Time passes.

* * *

>s
Bobbys
You can see Mom and a toybox (closed) here.

to saltShared Bathroom1

>l
Bobby's Bedroom
You can see Mom and a toybox (closed) here.

to salt

>wait
Time passes.

to salt

* * *

>wait
Time passes.

yourself and Mom
Mom goes west.

to saltShared Bathroom1

>w
My Bedroom
This is my bedroom. There is a shelf with nothing on it.

You can see Mom, a kiddie stool, a my bed and a dresser here.

yourself and Mom
Mom goes south.

to saltShared Bathroom0 unsaltedShared Bathroom

>s
Shared Bathroom
I share this bathroom with my brother, Bobby.

You can see Mom and a mirror here.

>wait
Time passes.

* * *

>w
My Bedroom
This is my bedroom. There is a shelf with nothing on it.

You can see Mom, a kiddie stool, a my bed and a dresser here.

yourself and Mom
Mom goes south.

to saltShared Bathroom0 unsaltedShared Bathroom

>wait
Time passes.

yourself
Mom arrives from the south.

going back

>wait
Time passes.

Mom and yourself
Mom goes east.

going back

>l
My Bedroom
This is my bedroom. There is a shelf with  a teddy bear on it. 

You can see a kiddie stool, a my bed and a dresser here.

yourself
going back

>e
Small Hall
You can see a hall closet (closed) here.

going back

>wait
Time passes.

going back

>ACTIONS
Actions listing on.

>wait
[waiting]
Time passes.
[waiting - succeeded]

[Mom going east]
[Mom going east - failed the can't go that way rule]

going back

* * *

>wait
Time passes.

Mom and yourself
Mom goes east.

going back

>e
Small Hall
You can see Mom and a hall closet (closed) here.

yourself and Momacttwolitcarried"Click." 
The lights go off.
lightsgooutThat's already closed.

vacuum back
It is now pitch dark in here!

>undo
My Bedroom
[Previous turn undone.]

>e
Small Hall
You can see Mom and a hall closet (closed) here.

yourself and MomThat's already closed.

vacuum back

* * *

>wait
Time passes.

DEBUG: dadvision is empty
DEBUG: dad looking for thingsmom is light-policing 
mom is locating salt 

DEBUG: Mom wanders to the Small Hall
DEBUG: Teddy's is deciding
 DEBUG: teddy is in the Your Bedroom

>ACTIONS
Actions listing on.

>WAIT
[waiting]
Time passes.
[waiting - succeeded]

yourselfactyou alonelitcarried"Click." 
The lights go off.

It is now pitch dark in here!

>wait
[waiting]
Time passes.
[waiting - succeeded]

yourself
[Mom going south]
[Mom going south - succeeded]

to saltShared Bathroom1

>e
[going east]

Small Hall
You can see a hall closet (closed) here.

[going east - succeeded]

yourselfactyou alonelitcarried"Click." 
The lights go off.

[Mom going south]
[Mom going south - failed the can't go that way rule]

to saltShared Bathroom1 
It is now pitch dark in here!

>wait
[waiting]
Time passes.
[waiting - succeeded]

yourself
[Mom going south]
[Mom going south - failed the can't go that way rule]

to saltShared Bathroom1

* * *

>wait
Time passes.

DEBUG: dadvision is empty
DEBUG: dad looking for thingsmom is light-policing 
mom is locating salt 

DEBUG: Mom wanders to the Small Hall
DEBUG: Teddy's is deciding
 DEBUG: teddy is in the Your Bedroom

>pour salt on ground
You pour the salt on the floor.

>wait
Time passes.

actother numberlitlightsgoout
It is now pitch dark in here!

>get on stool
You get onto the kiddie stool.

"Click." 
The lights go on.
yourself
My Bedroom (on the kiddie stool)
This is my bedroom. There is a shelf with nothing on it.

You can see Mom, a my bed and a dresser here.

* * *

>wait
Time passes.

DEBUG: dadvision is empty
DEBUG: dad looking for thingsmom is light-policing 
mom is locating salt 

DEBUG: Mom wanders to the Small Hall
DEBUG: Teddy's is deciding
 DEBUG: teddy is in the Your Bedroom

>push stool e
You push the kiddie stool east to the Small Hall.

Small Hall
You can see a hall closet (closed) here.

yourself

>push stool e
You push the kiddie stool east to the Living Room.

Living Room

>pour salt on ground
You pour the salt on the floor.

>wait
Time passes.

* * *

>wait
Time passes.

actother numberlitwander

>wait
Time passes.

Mom

>wait
Time passes.

Momactother alonelitlightsgoout

>wait
Time passes.

Mom

>wait
Time passes.

Mom

>e
Laundry Room
You can see a dryer (closed) and a washer (closed) here.

Mom

>e
You can't go that way.

Mom

>e
You can't go that way.

Mom

>w
Living Room
You can see a kiddie stool here.

Mom

>s
entry hall
You can see Bobby here.

Mom

>s
You can't go that way.

Mom

>n
Living Room
You can see a kiddie stool here.

Momactother alonelitlightsgoout

>w
Small Hall
You can see a hall closet (closed) here.

Mom

>wait
Time passes.

Mom

* * *

>wait
Time passes.

Momactother alonelitlightsgoout

>w
My Bedroom
This is my bedroom. There is a shelf with  a teddy bear on it. 

You can see Mom, a my bed and a dresser here.

yourself and Mom

>wait
Time passes.

yourself and Mom

>e
Small Hall
You can see a hall closet (closed) here.

Mom

>e
Living Room
You can see a kiddie stool here.

Mom

>pour salt on ground
You pour the salt on the floor.

Momactother alonelitlightsgoout

>wait
Time passes.

Mom

* * *

>e
Laundry Room
You can see a dryer (closed) and a washer (closed) here.

Mom

>w
Living Room
You can see a kiddie stool here.

Mom

>w
Small Hall
You can see a hall closet (closed) here.

Momactother alonelitlightsgoout

>w
My Bedroom
This is my bedroom. There is a shelf with  a teddy bear on it. 

You can see Mom, a my bed and a dresser here.

yourself and Mom

* * *

>get on teddy
That's not something you can enter.

>ACTIONS
Actions listing on.

>climb on teddy
You can't see any such thing.

>I
[taking inventory]
You are carrying nothing.

[taking inventory - succeeded]

"Click."
It is now pitch dark in here!

>turn on lights
[switching on the light switch]
[switching on the light switch - failed]

>s
That's not a verb I recognise.

* * *

>take stool
It's too heavy to carry, but you may be able to push it in a direction.

mom is light-policing 
mom is locating salt 

Mom goes east.

teddy is in the Your Bedroom

>turn on light
You are too small to reach the switch.

>get on stool
You get onto the kiddie stool.

>turn off light
You are too small to reach the switch.

* * *

>take stool
It's too heavy to carry, but you may be able to push it in a direction.

mom is light-policing 
mom is locating salt 

Mom goes east.

teddy is in the Your Bedroom

>push stool to shared bathroom
You can't see any such thing.

* * *

>get on stool
You get onto the step stool.

teddy is in the Your Bedroom

>turn off lights
"Click." 
The lights go off.

teddy is in the Your Bedroom

    *** Teddy got you. ***

Would you like to RESTART, RESTORE a saved game, QUIT or UNDO the last command?

>get off stool
You can't see any such thing.

>s
That's not a verb I recognise.

>turn on lights
"Click."
My Bedroom (on the kiddie stool)
This is my bedroom. There is a shelf with  a teddy bear on it. 

You can see Mom and a salt here.

>s
(first getting off the kiddie stool)

Shared Bathroom

>turn off lights
You are too small to reach the switch.

>wait
Time passes.

>n
My Bedroom
This is my bedroom. There is a shelf with  a teddy bear on it. 

You can see Mom, a kiddie stool and a salt here.

* * *

>wait
Time passes.

"Click."
It is now pitch dark in here!

>s
That's not a verb I recognise.

* * *

>turn off lights
"Click." 
The lights go off.

teddy is in the Your Bedroom

    *** Teddy got you. ***

Would you like to RESTART, RESTORE a saved game, QUIT or UNDO the last command?

>turn on lights
mom is light-policing 
mom is locating salt 

Mom goes north.

teddy is in the Your Bedroom

>get on stool
But you're already on the kiddie stool.

>turn on light switch
You can't see any such thing.

* * *

>turn on lights
mom is light-policing 
mom is locating salt 

Mom goes north.

teddy is in the Your Bedroom

>wait
Time passes.

Mom and yourselfacttwolitnot carriedlightsgoout

>i
You are carrying:
  a salt shaker

Mom and yourself

>wait
Time passes.

Mom and yourself

>wait
Time passes.

Mom and yourselfacttwolitnot carried

>l
Your Bedroom (on the kiddie stool)
This is your bedroom. There is a shelf with nothing on it.

You can see Mom, your bed and a dresser here.

Mom and yourself

>i
You are carrying:
  Teddy
  a salt shaker

Mom and yourself

>wait
Time passes.

Mom and yourself

>l
Your Bedroom (on the kiddie stool)
This is your bedroom. There is a shelf with nothing on it.

You can see Mom, your bed and a dresser here.

Mom and yourself

* * *

>wait
Time passes.

Mom and yourself

>drop dteddy
You can't see any such thing.

>drop teddy
Dropped.

Mom and yourselfacttwolitnot carried

>i
You are carrying:
  Teddy
  a salt shaker

Mom and yourself

* * *

>wait
Time passes.

Mom and yourself

>get off stool
You get off the kiddie stool.

Your Bedroom
This is your bedroom. There is a shelf with nothing on it.

You can see Mom, a kiddie stool, your bed and a dresser here.

yourself and Mom

>wait
Time passes.

yourself and Mom

>l
Your Bedroom
This is your bedroom. There is a shelf with nothing on it.

You can see Mom, a kiddie stool, your bed and a dresser here.

yourself and Mom

* * *

>wait
Time passes.

yourself and Momacttwolitcarriedlightsgoout

>l
Your Bedroom
This is your bedroom. There is a shelf with nothing on it.

You can see Mom, a kiddie stool, your bed and a dresser here.

yourself and Mom

>i
You are carrying:
  Teddy
  a salt shaker

yourself and Mom

* * *

>turn off lights
"Click." 
The lights go off.

teddy is in the Your Bedroom

    *** Teddy got you. ***

Would you like to RESTART, RESTORE a saved game, QUIT or UNDO the last command?

>l
Darkness
It is pitch dark, and you can't see a thing.

>get off stool
You get off the kiddie stool.

Darkness
It is pitch dark, and you can't see a thing.

>l
Darkness
It is pitch dark, and you can't see a thing.

* * *

>get on stool
You get onto the kiddie stool.

>l
Darkness
It is pitch dark, and you can't see a thing.

>turn on lights
"Click."
My Bedroom (on the kiddie stool)
This is my bedroom. There is a shelf with  a teddy bear on it. 

You can see a salt here.

>s
(first getting off the kiddie stool)

Shared Bathroom

* * *

>i
You are carrying nothing.

>turn on lights
"Click." The lights go on.

My Bedroom (on the kiddie stool)
This is my bedroom. There is a shelf with  a teddy bear on it. 

You can see Mom and a salt here.

>i
You are carrying nothing.

* * *

>turn off lights
"Click." 
The lights go off.

teddy is in the Your Bedroom

    *** Teddy got you. ***

Would you like to RESTART, RESTORE a saved game, QUIT or UNDO the last command?

>turn off the lights
It isn't something you can switch.

yourself

>turn off lights
It isn't something you can switch.

yourself

* * *

>turn off lights
"Click." 
The lights go off.

teddy is in the Your Bedroom

    *** Teddy got you. ***

Would you like to RESTART, RESTORE a saved game, QUIT or UNDO the last command?

>wait
Time passes.

Mom and yourself

* * *

>turn off lights
"Click." 
The lights go off.

teddy is in the Your Bedroom

    *** Teddy got you. ***

Would you like to RESTART, RESTORE a saved game, QUIT or UNDO the last command?

>undo
Your Bedroom
[Previous turn undone.]

>turn off lights
"Click." 
The lights go off.

teddy is in the Your Bedroom

It is now pitch dark in here!

>undo
Your Bedroom
[Previous turn undone.]

>l
Your Bedroom (on the step stool)
This is your bedroom. There is a shelf with a teddy bear on it. 

You can see Mom, your bed, a dresser and a hamper (empty) here.

mom is light-policing 
mom is locating salt 

Mom goes east.

teddy is in the Your Bedroom

>turn off lights
"Click." 
The lights go off.

mom is light-policing 
mom is locating salt 

teddy is in the Your Bedroom

>wait
Time passes.

teddy is in the Your Bedroom

>wait
Time passes.

teddy is in the Your Bedroom

>turn on lights
"Click." 
The lights go on.

mom is light-policing 
mom is locating salt 

teddy is in the Your Bedroom

* * *

>get on stool
You get onto the step stool.

teddy is in the Your Bedroom

>turn on lights
"Click." The lights go on.

"Click." The lights go off.

>turn off lights
"Click."
It is now pitch dark in here!

>get off stool
You get off the kiddie stool.

Darkness
It is pitch dark, and you can't see a thing.

>s
Shared Bathroom

>n
Darkness
It is pitch dark, and you can't see a thing.

* * *

>wait
Time passes.

>get on stool
You can't see any such thing.

* * *

>l
Darkness
It is pitch dark, and you can't see a thing.

>turn on lights
"Click."

>l
Darkness
It is pitch dark, and you can't see a thing.

* * *

>turn on lights
"Click." The lights go on.

"Click." The lights go off.

>turn on lights
"Click." The lights go on.

"Click." The lights go off.

* * *

>get on stool
You get onto the step stool.

teddy is in the Your Bedroom

>turn off light switch
"Click."
It is now pitch dark in here!

>turn on light switch
You can't see any such thing.

* * *

>get on stool
You get onto the step stool.

teddy is in the Your Bedroom

>turn off lights'
You can't see any such thing.

>turn off lights
"Click."
It is now pitch dark in here!

>turn on lights
"Click."
My Bedroom (on the kiddie stool)
This is my bedroom. There is a shelf with  a teddy bear on it. 

You can see Mom and a salt here.

>turn off lights
"Click."
It is now pitch dark in here!

>get down
You get off the kiddie stool.

Darkness
It is pitch dark, and you can't see a thing.

>s
Shared Bathroom

* * *

>n
Darkness
It is pitch dark, and you can't see a thing.

>l
Darkness
It is pitch dark, and you can't see a thing.

* * *

>i
You are carrying nothing.

>get on stool
You can't see any such thing.

* * *

>get on stool
You get onto the step stool.

teddy is in the Your Bedroom

>l
My Bedroom (on the kiddie stool)
This is my bedroom. There is a shelf with  a teddy bear on it. 

You can see a salt here.

* * *

>get on stool
You get onto the step stool.

teddy is in the Your Bedroom

>turn off light
"Click." The lights go off.

It is now pitch dark in here!

>i
You are carrying nothing.

* * *

>get on stool
You get onto the step stool.

teddy is in the Your Bedroom

>wait
Time passes.

Mom: Bobby! Stop playing with the lights!

Exasperated, Mom switches on the lights.
"Click." 
The lights go on.
Mom and yourself
My Bedroom (on the kiddie stool)
This is my bedroom. There is a shelf with  a teddy bear on it. 

You can see Mom, a my bed and a dresser here.

>wait
Time passes.

Mom and yourself

>wait
Time passes.

yourself

>wait
Time passes.

yourselfactyou alonelitcarried"Click." 
The lights go off.

It is now pitch dark in here!

>wait
Time passes.

Mom and yourself

>ait
That's not a verb I recognise.

>wait
Time passes.

Mom and yourself

* * *

>wait
Time passes.

Mom and yourselfacttwolitnot carried

>i
You are carrying:
  Teddy

Mom and yourself

>s
(first getting off the kiddie stool)

Shared Bathroom
I share this bathroom with my brother, Bobby.

You can see a mirror here.

yourself

>look in mirror
I can see myself in it.
yourself

>i
You are carrying:
  Teddy

yourself

>drop teddy
Dropped.

yourself

>look in mirror
I can see myself in it, with a teddy bear behind me.
yourselfactyou alonelitnot carried

* * *

>wait
Time passes.

Mom and yourself

>pour salt on ground
You pour the salt on the floor.

yourself

>wait
Time passes.

yourself

>wait
Time passes.

Mom goes east.

yourself

* * *

>wait
Time passes.

yourself

>wait
Time passes.

Mom goes west.

You hear the whirring of a vacuum cleaner some distance away.
yourself

>wait
Time passes.

yourself

>e
(first getting off the kiddie stool)

Small Hall
You can see a hall closet (closed) here.

>w
My Bedroom
This is my bedroom. There is a shelf with nothing on it.

You can see Mom, a kiddie stool, a my bed and a dresser here.

>wai
That's not a verb I recognise.

>l
My Bedroom
This is my bedroom. There is a shelf with nothing on it.

You can see Mom, a kiddie stool, a my bed and a dresser here.

* * *

>S
Shared Bathroom
I share this bathroom with my brother, Bobby.

You can see a mirror here.

>ACTIONS
Actions listing on.

>LOOK IN MIRROR
[searching the mirror]
You find nothing of interest.
[searching the mirror - failed the can't search unless container or supporter rule]

* * *

>S
Shared Bathroom
I share this bathroom with my brother, Bobby.

You can see a mirror here.

>wait
Time passes.

* * *

>wait
Time passes.

"Click." The lights go off.

It is now pitch dark in here!

>i
You are carrying:
  Teddy

    *** Teddy got you. ***

Would you like to RESTART, RESTORE a saved game, QUIT or UNDO the last command?

* * *

>S
Shared Bathroom
I share this bathroom with my brother, Bobby.

You can see a mirror here.

>N
My Bedroom
This is my bedroom. There is a shelf with nothing on it.

You can see Mom, a kiddie stool and a salt here.

>WAIT
Time passes.

>wait
Time passes.

* * *

>s
Shared Bathroom
I share this bathroom with my brother, Bobby.

You can see a mirror here.

>l
Shared Bathroom
I share this bathroom with my brother, Bobby.

You can see a mirror here.

* * *

>S
Shared Bathroom
I share this bathroom with my brother, Bobby.

You can see a mirror here.

>S
You can't go that way.

>N
My Bedroom
This is my bedroom. There is a shelf with nothing on it.

You can see Mom, a kiddie stool and a salt here.

>wait
Time passes.

>s
Shared Bathroom
I share this bathroom with my brother, Bobby.

You can see a mirror here.

* * *

>n
My Bedroom
This is my bedroom. There is a shelf with nothing on it.

You can see Mom, a kiddie stool and a salt here.

>e
Small Hall

* * *

>s
Bobby's Bedroom

>n
Small Hall

>w
My Bedroom
This is my bedroom. There is a shelf with nothing on it.

You can see Mom, a kiddie stool and a salt here.

>s
Shared Bathroom
I share this bathroom with my brother, Bobby.

You can see a mirror here.

"Click." The lights go off.

It is now pitch dark in here!

>n
My Bedroom
This is my bedroom. There is a shelf with nothing on it.

You can see Mom, a kiddie stool and a salt here.

* * *

>get on stool
You get onto the kiddie stool.

>turn on lights
"Click." The lights go on.

Shared Bathroom (on the kiddie stool)
I share this bathroom with my brother, Bobby.

You can see a mirror here.

>look in mirror
I can see myself in it.

* * *

>i
You are carrying:
  Teddy

>drop teddy
Dropped.

>look in mirror
I can see myself in it.

>take teddy
Taken.

>drop teddy
Dropped.

>n
(first getting off the kiddie stool)

My Bedroom
This is my bedroom. There is a shelf with nothing on it.

You can see Mom and a salt here.

>wait
Time passes.

>l
My Bedroom
This is my bedroom. There is a shelf with nothing on it.

You can see Mom and a salt here.

>l
My Bedroom
This is my bedroom. There is a shelf with nothing on it.

You can see Mom and a salt here.

>l
My Bedroom
This is my bedroom. There is a shelf with nothing on it.

You can see Mom and a salt here.

"Click." The lights go off.

It is now pitch dark in here!

>s
Shared Bathroom
I share this bathroom with my brother, Bobby.

You can see a kiddie stool and a mirror here.

>push stool north
You push the kiddie stool north to the My Bedroom.

Darkness
It is pitch dark, and you can't see a thing.

>get on stool
You get onto the kiddie stool.

* * *

>turn on lights
"Click." The lights go on.

My Bedroom (on the kiddie stool)
This is my bedroom. There is a shelf with nothing on it.

You can see Mom and a salt here.

>i
You are carrying:
  Teddy

* * *

>drop teddy
Dropped.

>l
My Bedroom (on the kiddie stool)
This is my bedroom. There is a shelf with nothing on it.

You can see Mom and a salt here.

>i
You are carrying nothing.

>l
My Bedroom (on the kiddie stool)
This is my bedroom. There is a shelf with nothing on it.

You can see Mom and a salt here.

* * *

>i
You are carrying nothing.

>take teddy
Taken.

* * *

>drop teddy
Dropped.

>i
You are carrying nothing.

* * *

>l
My Bedroom (on the kiddie stool)
This is my bedroom. There is a shelf with nothing on it.

You can see Mom and a salt here.

>take teddy
Taken.

* * *

>drop teddy
Dropped.

>s
(first getting off the kiddie stool)

Shared Bathroom
I share this bathroom with my brother, Bobby.

You can see a mirror here.

>n
My Bedroom
This is my bedroom. There is a shelf with nothing on it.

You can see a kiddie stool (on which is Teddy), Mom and a salt here.

* * *

>cry
Tears well up in your eyes as you sob without restraint.

Mom rushes into the room.
"What's wrong baby? Are you okay?"

Time passes as Mom soothes you.

 
DEBUG: teddy acts"Click." 
The lights go off.

 DEBUG: teddy is in the Your Bedroom
It is now pitch dark in here!

>s
Shared Bathroom
I share this bathroom with my brother, Bobby.

You can see a mirror here.

yourselfactyou alonelitcarried"Click." 
The lights go off.

It is now pitch dark in here!

* * *

>cry
Tears well up in your eyes as you sob without restraint.

Mom rushes into the room.
"What's wrong baby? Are you okay?"

Time passes as Mom soothes you.

 
DEBUG: teddy acts"Click." 
The lights go off.

 DEBUG: teddy is in the Your Bedroom
It is now pitch dark in here!

>cry
Tears well up in your eyes as you sob without restraint.

Mom rushes into the room.

Mom:"What's wrong baby? Are you okay?"

Time passes as Mom soothes you.

turnno vacuume time
Mom goes south.

mom wandersyourself

* * *

>cry
Tears well up in your eyes as you sob without restraint.

Mom rushes into the room.
"What's wrong baby? Are you okay?"

Time passes as Mom soothes you.

 
DEBUG: teddy acts"Click." 
The lights go off.

 DEBUG: teddy is in the Your Bedroom
It is now pitch dark in here!

>drop salt
Teddy heard you
Dropped.

mom is light-policing 
mom is locating salt 

Mom arrives from the south.

"Click." 
The lights go off.

teddy is in the Your Bedroom
It is now pitch dark in here!

* * *

>cry
Tears well up in your eyes as you sob without restraint.

Mom rushes into the room.
"What's wrong baby? Are you okay?"

Time passes as Mom soothes you.

 
DEBUG: teddy acts"Click." 
The lights go off.

 DEBUG: teddy is in the Your Bedroom
It is now pitch dark in here!

>wait
Time passes.

DEBUG: dadvision is empty
DEBUG: dad looking for thingsDEBUG: dad wanders to the shared bathroommom is light-policing 
"Who keeps turning off the lights?"
Exasperated, Mom switches on the lights.
"Click." 
The lights go on.
mom is locating salt 
DEBUG: Mom wanders to the shared bathroom 
DEBUG: teddy acts
 DEBUG: teddy is in the Your Bedroom
Your Bedroom
This is your bedroom. There is a shelf with nothing on it.

You can see a hamper (in which is your lucky boxers), a widget, your bed and a dresser here.

>i
You are carrying:
  Teddy
  a salt shaker

>put teddy on stool
You can't see any such thing.

>put teddy in hamper
You put Teddy into the hamper.

DEBUG: Chaser is wandering to the shared bathroom
 DEBUG: teddy is in the Your Bedroom

>l
Your Bedroom
This is your bedroom. There is a shelf with nothing on it.

You can see a hamper (in which are Teddy and your lucky boxers), a widget, your bed and a dresser here.

 DEBUG: teddy is in the Your Bedroom

>take boxers
Taken.

DEBUG: Chaser is wandering to the Small Hallmom is light-policing 
mom is locating salt 
DEBUG: Mom wanders to the shared bathroom
 DEBUG: teddy is in the Your Bedroom

>l
Your Bedroom
This is your bedroom. There is a shelf with nothing on it.

You can see a hamper (in which is Teddy), a widget, your bed and a dresser here.

mom is light-policing 
mom is locating salt 
DEBUG: Mom wanders to the shared bathroom
 DEBUG: teddy is in the Your Bedroom

>wait
Time passes.

DEBUG: dadvision is empty
DEBUG: dad looking for thingsDEBUG: dad wanders to the Small HallDEBUG: Chaser is wandering to the Small Hallmom is light-policing 
mom is locating salt 
DEBUG: Mom wanders to the shared bathroom 
DEBUG: teddy acts
 DEBUG: teddy is in the Your Bedroom

>l
Your Bedroom
This is your bedroom. There is a shelf with nothing on it.

You can see a hamper (empty), a widget, your bed and a dresser here.

 DEBUG: teddy is in the Your Bedroom

>i
You are carrying:
  Teddy
  your lucky boxers
  a salt shaker

>e
Small Hall
You can see Chaser, dad and a hall closet (closed) here.

 DEBUG: teddy is in the Small Hall

>w
Your Bedroom
This is your bedroom. There is a shelf with nothing on it.

You can see a hamper (empty), a widget, your bed and a dresser here.

 DEBUG: teddy is in the Your Bedroom

>s
shared bathroom
I share this bathroom with my brother, Bobby.

You can see Mom, a mirror and a cabinet (closed) here.

mom is light-policing 
mom is locating salt 
DEBUG: Mom wanders to the Small Hall 
DEBUG: teddy acts"Click." 
The lights go off.

 DEBUG: teddy is in the shared bathroom
It is now pitch dark in here!

>w
You can't go that way.

mom is light-policing 
mom is locating salt 
DEBUG: Mom wanders to the Small Hall
 DEBUG: teddy is in the shared bathroom

>e
Bobby's Bedroom
You can see a toybox (closed) here.

mom is light-policing 
mom is locating salt 
DEBUG: Mom wanders to the shared bathroom
 DEBUG: teddy is in the Bobby's Bedroom

>e
Entry Hall
You can see a front door here.

mom is light-policing 
mom is locating salt 
DEBUG: Mom wanders to the shared bathroom 
DEBUG: teddy acts"Click." 
The lights go off.

 DEBUG: teddy is in the Entry Hall
It is now pitch dark in here!

>n
Living Room

 DEBUG: teddy is in the Living Room

>n
Kitchen
You can see a pantry (closed) here.

DEBUG: dadvision is empty
DEBUG: dad looking for thingsDEBUG: dad wanders to the Small Hallmom is light-policing 
mom is locating salt 
DEBUG: Mom wanders to the Small Hall 
DEBUG: teddy acts"Click." 
The lights go off.

 DEBUG: teddy is in the Kitchen
It is now pitch dark in here!

>w
You can't go that way.

mom is light-policing 
mom is locating salt 
DEBUG: Mom wanders to the Small Hall
 DEBUG: teddy is in the Kitchen

>e
Dining Room
You can see a dog bed (on which is a rubber ball), a high chair and a table here.

DEBUG: Chaser is wandering to the Small Hallmom is light-policing 
mom is locating salt 
DEBUG: Mom wanders to the Small Hall 
DEBUG: teddy acts"Click." 
The lights go off.

 DEBUG: teddy is in the Dining Room
It is now pitch dark in here!

>e
You can't go that way.

 
DEBUG: teddy acts
 DEBUG: teddy is in the Dining Room

    *** Teddy got you. ***

Would you like to RESTART, RESTORE a saved game, QUIT or UNDO the last command?

>undo
Darkness
[Previous turn undone.]

>e
You can't go that way.

DEBUG: Chaser is wandering to the shared bathroom
 DEBUG: teddy is in the Dining Room

>s
Laundry Room
You can see a washer (closed) and a dryer (closed) here.

mom is light-policing 
mom is locating salt 
DEBUG: Mom wanders to the Small Hall
 DEBUG: teddy is in the Laundry Room

>e
You can't go that way.

 
DEBUG: teddy acts"Click." 
The lights go off.

 DEBUG: teddy is in the Laundry Room
It is now pitch dark in here!

>w
Living Room

 DEBUG: teddy is in the Living Room

>w
Small Hall
You can see Mom, dad and a hall closet (closed) here.

DEBUG: dadvision is empty
DEBUG: dad looking for thingsDEBUG: dad wanders to the Small Hallmom is light-policing 
mom is locating salt 
DEBUG: Mom wanders to the Small Hall
 DEBUG: teddy is in the Small Hall

>drop boxers
DEBUG: Teddy heard you
Dropped.

mom is light-policing 
mom is locating salt 
DEBUG: Mom wanders to the shared bathroom
 DEBUG: teddy is in the Small Hall

>l
Small Hall
You can see your lucky boxers, dad and a hall closet (closed) here.

mom is light-policing 
mom is locating salt 
DEBUG: Mom wanders to the shared bathroom 
DEBUG: teddy acts"Click." 
The lights go off.

 DEBUG: teddy is in the Small Hall
It is now pitch dark in here!

>undo
Small Hall
[Previous turn undone.]

>wait
Time passes.

 DEBUG: teddy is in the Small Hall

>wait
Time passes.

DEBUG: Chaser is wandering to the shared bathroommom is light-policing 
mom is locating salt 
DEBUG: Mom wanders to the Small Hall
 DEBUG: teddy is in the Small Hall

>wait
Time passes.

 DEBUG: teddy is in the Small Hall

>wait
Time passes.

mom is light-policing 
mom is locating salt 
DEBUG: Mom wanders to the Small Hall
 DEBUG: teddy is in the Small Hall

>wait
Time passes.

 DEBUG: teddy is in the Small Hall

>wdrop teddy
That's not a verb I recognise.

>drop teddy
DEBUG: Teddy heard you
Dropped.

DEBUG: Chaser is wandering to the Small Hall
 DEBUG: teddy is in the Small Hall

>wait
Time passes.

Chaser picks up the lucky boxers.

 DEBUG: teddy is in the Small Hall

>take ball
You can't see any such thing.

* * *

>look
My Bedroom
This is my bedroom. There is a shelf with  a teddy bear on it. 

You can see Mom, a kiddie stool and a salt here.

>look
My Bedroom
This is my bedroom. There is a shelf with  a teddy bear on it. 

You can see Mom, a kiddie stool and a salt here.

>wait
Time passes.

* * *

>i
You are carrying nothing.

>look
My Bedroom
This is my bedroom. There is a shelf with  a teddy bear on it. 

You can see Mom, a kiddie stool and a salt here.

>look
My Bedroom
This is my bedroom. There is a shelf with  a teddy bear on it. 

You can see Mom, a kiddie stool and a salt here.

"Click."
It is now pitch dark in here!

>get on stool
You get onto the kiddie stool.

>turn on lights
My Bedroom (on the kiddie stool)
This is my bedroom. There is a shelf with  a teddy bear on it. 

You can see Mom and a salt here.

>i
You are carrying nothing.

* * *

>i
You are carrying nothing.

It is now pitch dark in here!

>turn on lights
My Bedroom (on the kiddie stool)
This is my bedroom. There is a shelf with  a teddy bear on it. 

You can see Mom and a salt here.

>i
You are carrying nothing.

It is now pitch dark in here!

* * *

>wait
Time passes.

>i
You are carrying nothing.

It is now pitch dark in here!

* * *

>turn on lights
My Bedroom (on the kiddie stool)
This is my bedroom. There is a shelf with  a teddy bear on it. 

You can see a salt here.

>look
My Bedroom (on the kiddie stool)
This is my bedroom. There is a shelf with  a teddy bear on it. 

You can see a salt here.

>i
You are carrying nothing.

* * *

>i
You are carrying:
  a salt shaker
  your lucky boxers

>i
You are carrying:
  a salt shaker

yourself, Mom and coin

>get on stool
You get onto the kiddie stool.

>turn off lights
"Click." The lights go off.

It is now pitch dark in here!

>i
You are carrying nothing.

* * *

>i
You are carrying:
  a salt shaker

yourself, Mom and coin

>i
You are carrying:
  a salt shaker

yourself, Mom and coin

>i
You are carrying:
  a salt shaker

yourself, Mom and coinactother numberlitwander

>drop teddy
Dropped.

yourself

>i
You are carrying nothing.

yourself

>i
You are carrying nothing.

yourself

>s
Shared Bathroom
I share this bathroom with my brother, Bobby.

You can see a roomba, Mom and a mirror here.

>wait
Time passes.

* * *

>i
You are carrying:
  a salt shaker
  your lucky boxers

>l
Your Bedroom
This is your bedroom. There is a shelf with a teddy bear on it. 

You can see Mom, a step stool, your bed, a dresser and a hamper (empty) here.

DEBUG: Chaser is wandering to the Shared Bathroomteddy is in the Your Bedroom

>l
Your Bedroom
This is your bedroom. There is a shelf with a teddy bear on it. 

You can see Mom, a step stool, your bed, a dresser and a hamper (empty) here.

mom is light-policing 
mom is locating salt 
DEBUG: Mom wanders to the Shared Bathroomteddy is in the Your Bedroom

>l
Your Bedroom
This is your bedroom. There is a shelf with a teddy bear on it. 

You can see a step stool, your bed, a dresser and a hamper (empty) here.

teddy is in the Your Bedroom

>l
Your Bedroom
This is your bedroom. There is a shelf with a teddy bear on it. 

You can see a step stool, your bed, a dresser and a hamper (empty) here.

mom is light-policing 
mom is locating salt 
DEBUG: Mom wanders to the Shared Bathroomteddy is in the Your Bedroom

* * *

>i
You are carrying:
  a salt shaker
  your lucky boxers

>get on stool
You get onto the kiddie stool.

* * *

>i
You are carrying:
  a salt shaker
  your lucky boxers

>s
Shared Bathroom
I share this bathroom with my brother, Bobby.

You can see Mom and a mirror here.

try

>i
You are carrying nothing.

try

>i
You are carrying nothing.

actother numberlitlightsgoout
try
It is now pitch dark in here!

* * *

>i
You are carrying:
  a salt shaker
  your lucky boxers

>l
Your Bedroom
This is your bedroom. There is a shelf with a teddy bear on it. 

You can see Mom, a step stool, your bed, a dresser and a hamper (empty) here.

"Click." 
The lights go off.
teddy is in the Your Bedroom

It is now pitch dark in here!

>i
You are carrying:
  your lucky boxers
  a salt shaker

>examine salt shaker
It is pitch dark, and you can't see a thing.

mom is light-policing 
Mom: Who keeps turning off the lights?

Exasperated, Mom switches on the lights.
"Click." 
The lights go on.
mom is locating salt 

teddy is in the Your Bedroom

Your Bedroom
This is your bedroom. There is a shelf with a teddy bear on it. 

You can see a step stool, your bed, a dresser and a hamper (empty) here.

* * *

>push stool south
You push the kiddie stool south to the Shared Bathroom.

Shared Bathroom
I share this bathroom with my brother, Bobby.

You can see a mirror here.

>look in mirror
I can see myself in it.

* * *

>wait
Time passes.

>look in mirror
I can see myself in it.
"Click." The lights go off.

>get on stool
You get onto the kiddie stool.

>turn on lights
The lights are already on.

>look in mirror
I can see myself in it.

* * *

>wait
Time passes.

"Click." The lights go off.

It is now pitch dark in here!

>turn on lights
"Click." The lights go on.

Shared Bathroom (on the kiddie stool)
I share this bathroom with my brother, Bobby.

You can see a mirror here.

>look in mirror
I can see myself in it, with a teddy bear behind me.

>wait
Time passes.

"Click." The lights go off.

It is now pitch dark in here!

>turn on lights
"Click." The lights go on.

"Click." The lights go off.

>turn on lights
"Click." The lights go on.

Shared Bathroom (on the kiddie stool)
I share this bathroom with my brother, Bobby.

You can see a mirror here.

>wait
Time passes.

* * *

>turn on lights
"Click." The lights go on.

Shared Bathroom (on the kiddie stool)
I share this bathroom with my brother, Bobby.

You can see a mirror here.

>i
You are carrying nothing.

"Click." The lights go off.

It is now pitch dark in here!

>turn on lights
"Click." The lights go on.

Shared Bathroom (on the kiddie stool)
I share this bathroom with my brother, Bobby.

You can see a mirror here.

>wait
Time passes.

"Click." The lights go off.

It is now pitch dark in here!

* * *

>i
You are carrying nothing.

"Click." The lights go off.

It is now pitch dark in here!

>turn on lights
"Click." The lights go on.

"Click." The lights go off.

* * *

>wait
Time passes.

>i
You are carrying nothing.

"Click." The lights go off.

It is now pitch dark in here!

* * *

>look
Darkness
It is pitch dark, and you can't see a thing.

>turn on lights
"Click." The lights go on.

"Click." The lights go off.

* * *

>turn on lights
"Click." The lights go on.

Shared Bathroom (on the kiddie stool)
I share this bathroom with my brother, Bobby.

You can see a mirror here.

>look in mirror
I can see myself in it, with a teddy bear behind me.
"Click." The lights go off.

It is now pitch dark in here!

* * *

>e
Small Hall
You can see a dog bed (on which is a rubber ball), Chaser and a hall closet (closed) here.

 DEBUG: teddy is in the Your Bedroom

>e
Living Room
You can see a high chair here.

 DEBUG: teddy is in the Your Bedroom

>e
Laundry Room
You can see a washer (closed) and a dryer (closed) here.

DEBUG: Chaser is wandering to the shared bathroom 
DEBUG: teddy acts"Click." 
The lights go off.

 DEBUG: teddy is in the Laundry Room
It is now pitch dark in here!

>e
You can't go that way.

teddy is in the Your Bedroom

>i
You are carrying nothing.

Momactother alonedarkkilledone

>wait
Time passes.

>e
You can't go that way.

* * *

>w
Living Room

>wait
Time passes.

>wait
Time passes.

actother numberdarkchase

>wait
Time passes.

actother numberlitlightsgoout

>wait
Time passes.

* * *

>wait
Time passes.

actother numberdarkchase

>wait
Time passes.

yourself

* * *

>wait
Time passes.

yourselfactyou alonelitnot carried

>i
You are carrying:
  Teddy

yourself

>put teddy in dryer
You can't see any such thing.

>e
Laundry Room
You can see a dryer (closed) here.

yourselfactyou alonelitcarried"Click." The lights go on.

It is now pitch dark in here!

>RESTART
Are you sure you want to restart?

>Y
Bad Teddy
An Interactive Fiction by "Y'Gael of Atrii" this is a subtitle
Release 1 / Serial number 201215 / Inform 7 build 6M62 (I6/v6.33 lib 6/12N) SD

My Bedroom
This is my bedroom. There is a shelf with  a teddy bear on it. 

You can see Mom, a kiddie stool and a salt here.

>take tedd
You can't see any such thing.

>take teddy
Taken.

yourself and Momacttwolitcarried"Click." The lights go on.
lightsgoout
It is now pitch dark in here!

>e
Small Hall
yourself

>e
Living Room
yourself

* * *

>e
Laundry Room
You can see a dryer (closed) here.

yourself

>put teddy in dryer
The dryer is closed.

yourself

>open dryer
You open the dryer.

yourself

>put teddy in dryer
You put Teddy into the dryer.

yourselfact

>close dryer
You close the dryer.

yourselfactyou alonelitnot carried

>i
You are carrying:
  Teddy

yourselfactyou alonelitcarried"Click." The lights go on.

It is now pitch dark in here!

>open dryer
You can't see any such thing.

>undo
Darkness
[Previous turn undone.]

>undo
Laundry Room
[Previous turn undone.]

>open dryer
You open the dryer.

yourself

* * *

>wait
Time passes.

yourself

>wait
Time passes.

yourselfact

>i
You are carrying nothing.

yourself

>l
Laundry Room
You can see a dryer (closed) here.

yourselfactyou alonelitnot carried

* * *

>e
You can't go that way.

teddy is in the Your Bedroom

>open washer
You open the washer.

teddy is in the Your Bedroom

>put boxers in washer
You put the lucky boxers into the washer.

teddy is in the Your Bedroom

>close washer
You close the washer.

teddy is in the Your Bedroom

>turn on washer
You turn the washer on
You hear the sloshing of the washer.

teddy is in the Your Bedroom

>i
You are carrying:
  a salt shaker

You hear the sloshing of the washer.

teddy is in the Your Bedroom

>i
You are carrying:
  a salt shaker

You hear the sloshing of the washer.

teddy is in the Your Bedroom

I beg your pardon?

>i
You are carrying:
  a salt shaker

You hear the sloshing of the washer.

teddy is in the Your Bedroom

>i
You are carrying:
  a salt shaker

You hear the sloshing of the washer.

teddy is in the Your Bedroom
"DING!"
You hear the sound of the washer completing it's cycle.

>open washer
You open the washer, revealing a wet boxers.

teddy is in the Your Bedroom

>take boxers
Taken.

teddy is in the Your Bedroom

>e
You can't go that way.

teddy is in the Your Bedroom

>w
Living Room
teddy is in the Your Bedroom

>w
Small Hall
You can see a Mom and a hall closet (closed) here.

teddy is in the Your Bedroom

>w
Darkness
It is pitch dark, and you can't see a thing.

teddy is in the Your Bedroom

>get on stol
You can't see any such thing.

>get on stool
You get onto the kiddie stool.

teddy is in the Your Bedroom

>take teddy
You can't see any such thing.

>turn on lights
teddy is in the Your Bedroom
Your Bedroom (on the kiddie stool)
This is your bedroom. There is a shelf with  a teddy bear on it. 

You can see your bed and a dresser here.

>take teddy
Taken.

teddy is in the Your Bedroom

>get off stool
You get off the kiddie stool.

Your Bedroom
This is your bedroom. There is a shelf with nothing on it.

You can see a kiddie stool, your bed and a dresser here.

teddy is in the Your Bedroom

>e
Small Hall
You can see a Mom and a hall closet (closed) here.

teddy is in the Small Hall

>e
Living Room
teddy is in the Living Room

>e
Laundry Room
You can see a washer (empty) and a dryer (closed) here.

teddy is in the Laundry Room

>put teddy in washer
You put Teddy into the washer.

teddy is in the Laundry Room

* * *

>turn on washer
You turn the washer on
You hear the sloshing of the washer.

teddy is in nothing

>wait
Time passes.

You hear the sloshing of the washer.

teddy is in nothing

>i
You are carrying:
  a wet boxers
  a salt shaker

You hear the sloshing of the washer.

teddy is in nothing

>i
You are carrying:
  a wet boxers
  a salt shaker

You hear the sloshing of the washer.

teddy is in nothing

>i
You are carrying:
  a wet boxers
  a salt shaker

You hear the sloshing of the washer.

teddy is in nothing
"BANG!"
You hear the sound of something breaking.

>turn on washer
You must wait until the wash cycle is over.

You hear the sloshing of the washer.

teddy is in the Laundry Room

* * *

>e
Laundry Room
You can see a washer (closed) and a dryer (closed) here.

DEBUG: Chaser is wandering to the shared bathroom 
DEBUG: teddy acts"Click." 
The lights go off.

 DEBUG: teddy is in the Laundry Room
It is now pitch dark in here!

>pour salt on ground
You pour the salt on the floor.

* * *

>wait
Time passes.

>wait
Time passes.

actother numberlitlightsgoout

* * *

>w
Living Room

>w
Small Hall
You can see a hall closet (closed) here.

>w
My Bedroom
This is my bedroom. There is a shelf with nothing on it.

You can see Mom, a kiddie stool, a my bed and a dresser here.

* * *

>e
Laundry Room
You can see a washer (closed) and a dryer (closed) here.

DEBUG: Chaser is wandering to the shared bathroom 
DEBUG: teddy acts"Click." 
The lights go off.

 DEBUG: teddy is in the Laundry Room
It is now pitch dark in here!

>s
Garage
turnno vacuume timeMom is wandering
mom wandersBobbyactother alonelitlightsgoout

>pour salt on ground
You pour the salt on the floor.

turnvaccum timesalted roomBobby

>wait
Time passes.

turnvaccum timesalted room
tryBobby

>wait
Time passes.

turnvaccum timesalted room
tryBobby

>wait
Time passes.

turnvaccum timesalted room
Mom arrives from the north.

tryBRRRRRR!
Mom scolds you sternly for spilling salt on her floors, then vacuums up the mess.
Bobby

* * *

>e
Laundry Room
You can see a washer (closed) and a dryer (closed) here.

DEBUG: Chaser is wandering to the shared bathroom 
DEBUG: teddy acts"Click." 
The lights go off.

 DEBUG: teddy is in the Laundry Room
It is now pitch dark in here!

>turn on dryer
You turn the dryer on
teddy is in the Your Bedroom

>examine dryer
(the dryer)
You see nothing special about the dryer.

teddy is in the Your Bedroom

>examine dryer swtich
You can't see any such thing.

>examine switch
(the light switch)
You see nothing special about the light switch.

teddy is in the Your Bedroom

>examine dryer switch
The dryer switch is currently switched off.

teddy is in the Your Bedroom

>ACTIONS
Actions listing on.

>TURN ON DRYER
(the dryer)
[switching on the dryer]
[switching on the dryer - failed]

teddy is in the Your Bedroom

* * *

>turn on dryer
You turn the dryer on
teddy is in the Your Bedroom

>ACTIONS
Actions listing on.

>TURN ON DRYER
[switching on the dryer]
[switching on the dryer - failed]

teddy is in the Your Bedroom

* * *

>turn on dryer
You turn the dryer on
teddy is in the Your Bedroom

>turn on washer
increase : 1
teddy is in the Your Bedroom

>examine button
The washer is currently switched on.

teddy is in the Your Bedroom

>examine dryer
The dryer is on

teddy is in the Your Bedroom

>examine washer
You see nothing special about the washer.

teddy is in the Your Bedroom
0

* * *

>e
Laundry Room
You can see a washer (closed) and a dryer (closed) here.

DEBUG: Chaser is wandering to the shared bathroom 
DEBUG: teddy acts"Click." 
The lights go off.

 DEBUG: teddy is in the Laundry Room
It is now pitch dark in here!

>open dryer
You open the dryer.

teddy is in the Your Bedroom

>ACTIONS
Actions listing on.

>open dryer
(the dryer)
[opening the dryer]
[(1) opening the dryer door]
It isn't something you can open.
[(1) opening the dryer door - failed the can't open unless openable rule]

[opening the dryer - failed the can't open unless openable rule]

teddy is in the Your Bedroom

* * *

>open dryer
You open the dryer.

teddy is in the Your Bedroom

>put salt in dryer
You put the salt shaker into the dryer.

teddy is in the Your Bedroom

>close dryer
You close the dryer.

teddy is in the Your Bedroom

>ACTIONS
Actions listing on.

>close dryer
(the dryer)
[closing the dryer]
[(1) closing the dryer door]
That's already closed.
[(1) closing the dryer door - failed the can't close what's already closed rule]

[closing the dryer - failed the can't close what's already closed rule]

teddy is in the Your Bedroom

>open dryer
(the dryer)
[opening the dryer]
[(1) opening the dryer door]
You open the dryer door, revealing a salt shaker.
[(1) opening the dryer door - succeeded]

[opening the dryer - failed]

teddy is in the Your Bedroom

>close dryer
(the dryer)
[closing the dryer]
[(1) closing the dryer door]
[(1) closing the dryer door - succeeded]

[closing the dryer - failed]

teddy is in the Your Bedroom

* * *

>close dryer
You close the dryer.

teddy is in the Your Bedroom

>turn on tryer
You can't see any such thing.

>turn on dryer
(the dryer)
teddy is in the Your Bedroom

>examine dryer switch
You see nothing special about the dryer switch.

teddy is in the Your Bedroom

>examine dial
You can't see any such thing.

* * *

>close dryer
You close the dryer.

teddy is in the Your Bedroom

>turn on dryer
you hear the sloshing of the washer.

teddy is in the Your Bedroom

>open dryer
the dryer is running. You must wait until the cycle is complete.

you hear the sloshing of the washer.

teddy is in the Your Bedroom

>wait
Time passes.

you hear the sloshing of the washer.

teddy is in the Your Bedroom

>wait
Time passes.

you hear the sloshing of the washer.

teddy is in the Your Bedroom

>e
You can't go that way.

you hear the sloshing of the washer.

teddy is in the Small Hall

>wait
Time passes.

you hear the sloshing of the washer.

teddy is in the Small Hall

*** Run-time problem P50: Attempt to use list item which does not exist.

* * *

>open dryer
You open the dryer.

teddy is in the Your Bedroom

>close dryer
(the dryer)
It isn't something you can close.

teddy is in the Laundry Room

* * *

>e
Laundry Room
You can see a washer (closed) and a dryer (closed) here.

DEBUG: Chaser is wandering to the shared bathroom 
DEBUG: teddy acts"Click." 
The lights go off.

 DEBUG: teddy is in the Laundry Room
It is now pitch dark in here!

>ACTIONS
Actions listing on.

>open dryer
[opening the dryer]
You open the dryer.
[opening the dryer - succeeded]

teddy is in the Your Bedroom

>examine dryer door
[examining the dryer door]
The dryer door is empty.

[examining the dryer door - succeeded]

teddy is in the Your Bedroom

* * *

>open dryer
[opening the dryer]
You open the dryer.
[opening the dryer - succeeded]

teddy is in the Your Bedroom

>put salt in dryer
[inserting the salt shaker into the dryer]
You put the salt shaker into the dryer.
[inserting the salt shaker into the dryer - succeeded]

teddy is in the Your Bedroom

>close dryer
[closing the dryer]
You close the dryer.
[closing the dryer - succeeded]

teddy is in the Your Bedroom

>turn on dryer
[switching on the dryer]
[(1) switching on the dryer]
[(1) switching on the dryer - succeeded]

[switching on the dryer - failed]

[the dresser going south]
[the dresser going south - succeeded]

teddy is in the Your Bedroom

>examine dryer
[examining the dryer]
The dryer is on.

[examining the dryer - succeeded]

teddy is in the Your Bedroom

>l
[looking]
Laundry Room
You can see a dryer (closed) and a washer (closed) here.

[looking - succeeded]

teddy is in the Your Bedroom

>wait
[waiting]
Time passes.
[waiting - succeeded]

teddy is in the Your Bedroom

>open dryer
[opening the dryer]
the dryer is running. You must wait until the cycle is complete.
[opening the dryer - failed]

[Teddy going east - silently]
[Teddy going east - silently - succeeded]

teddy is in the Small Hall

>open dryer
[opening the dryer]
the dryer is running. You must wait until the cycle is complete.
[opening the dryer - failed]

teddy is in the Small Hall

>open dryer
[opening the dryer]
the dryer is running. You must wait until the cycle is complete.
[opening the dryer - failed]

[the dresser going north]
[the dresser going north - succeeded]

teddy is in the Small Hall

>open dryer
[opening the dryer]
the dryer is running. You must wait until the cycle is complete.
[opening the dryer - failed]

teddy is in the Small Hall

>open dryer
[opening the dryer]
the dryer is running. You must wait until the cycle is complete.
[opening the dryer - failed]

teddy is in the Laundry Room

>open dryer
[opening the dryer]
the dryer is running. You must wait until the cycle is complete.
[opening the dryer - failed]

teddy is in the Laundry Room

>open dryer
[opening the dryer]
You open the dryer, revealing a salt shaker.
[opening the dryer - succeeded]

teddy is in the Laundry Room

>take salt
[taking the salt shaker]
[taking the salt shaker - failed]

teddy is in the Laundry Room

>l
[looking]
Laundry Room
You can see a dryer (in which is a salt shaker) and a washer (closed) here.

[looking - succeeded]

teddy is in the Laundry Room

>take salt
[taking the salt shaker]
[taking the salt shaker - failed]

[the dresser going east]
[the dresser going east - succeeded]

teddy is in the Laundry Room

* * *

>ACTIONS
Actions listing on.

>turn on dryer
[switching on the dryer]
[(1) switching on the dryer]
increase : 1[(1) switching on the dryer - succeeded]

[switching on the dryer - failed]

teddy is in the Your Bedroom

>examine dryer
[examining the dryer]
You see nothing special about the dryer.

[examining the dryer - succeeded]

teddy is in the Your Bedroom

* * *

>e
Laundry Room
You can see a washer (closed) and a dryer (closed) here.

DEBUG: Chaser is wandering to the shared bathroom 
DEBUG: teddy acts"Click." 
The lights go off.

 DEBUG: teddy is in the Laundry Room
It is now pitch dark in here!

>switch on dryer
increase : 1
teddy is in the Your Bedroom

>examine dryer
The dryer is on

teddy is in the Your Bedroom

* * *

>e
Laundry Room
You can see a washer (closed) and a dryer (closed) here.

DEBUG: Chaser is wandering to the shared bathroom 
DEBUG: teddy acts"Click." 
The lights go off.

 DEBUG: teddy is in the Laundry Room
It is now pitch dark in here!

>open drier
You can't see any such thing.

>open dryer
You open the dryer.

teddy is in the Your Bedroom

* * *

>close dryer
You close the dryer.

teddy is in the Your Bedroom

>turn on dryer
You turn the dryer on
teddy is in the Your Bedroom

>open dryer
You open the dryer, revealing a salt shaker.

teddy is in the Your Bedroom

>take salt
It is too high for you to reach.

teddy is in the Your Bedroom

* * *

>e
Laundry Room
You can see a washer (closed) and a dryer (closed) here.

DEBUG: Chaser is wandering to the shared bathroom 
DEBUG: teddy acts"Click." 
The lights go off.

 DEBUG: teddy is in the Laundry Room
It is now pitch dark in here!

>popen dryer
That's not a verb I recognise.

>open dryer
You open the dryer.

teddy is in the Your Bedroom

* * *

>put salt in dryer
You put the salt shaker into the dryer.

teddy is in the Your Bedroom

>take salt
Taken.

teddy is in the Your Bedroom

* * *

>e
Laundry Room
You can see a washer (closed) and a dryer (closed) here.

DEBUG: Chaser is wandering to the shared bathroom 
DEBUG: teddy acts"Click." 
The lights go off.

 DEBUG: teddy is in the Laundry Room
It is now pitch dark in here!

>open washer
You open the washer.

teddy is in the Your Bedroom

>put salt in washer
You put the salt shaker into the washer.

teddy is in the Laundry Room

>close washer
You close the washer.

teddy is in the Laundry Room

>turn on washer
You hear the sloshing of the washer.

teddy is in the Laundry Room

>wait
Time passes.

You hear the sloshing of the washer.

teddy is in the Laundry Room

>i
You are carrying:
  Teddy

You hear the sloshing of the washer.

teddy is in the Laundry Room

>open drier
You can't see any such thing.

* * *

>put teddy in dryer
You put Teddy into the dryer.

You hear the sloshing of the washer.

teddy is in the Laundry Room

>close dtryer
You can't see any such thing.

>close dryer
You close the dryer.

You hear the sloshing of the washer.

teddy is in the Laundry Room

>turn on dryer
you hear the whirring of the dryer.

You hear the sloshing of the washer.

teddy is in the Laundry Room

>wait
Time passes.

you hear the whirring of the dryer.

You hear the sloshing of the washer.

teddy is in the Laundry Room

>wait
Time passes.

you hear the whirring of the dryer.

You hear the sloshing of the washer.

teddy is in the Laundry Room

>w
Living Room
you hear the distant whirring of the dryer.

You hear the distant sloshing of the washer.

"Click." 
The lights go off.
teddy is in the Living Room
It is now pitch dark in here!

>e
Laundry Room
You can see a washer (closed) and a dryer (closed) here.

you hear the whirring of the dryer.

You hear the sloshing of the washer.

teddy is in the Laundry Room

>i
You are carrying:
  Teddy

you hear the whirring of the dryer.

teddy is in the Laundry Room

>wait
Time passes.

you hear the whirring of the dryer.

"Click." 
The lights go off.
teddy is in the Laundry Room
It is now pitch dark in here!

>undo
Laundry Room
[Previous turn undone.]

>wait
Time passes.

you hear the whirring of the dryer.

teddy is in the Laundry Room

>open washer
You open the washer, revealing a salt shaker.

you hear the whirring of the dryer.

teddy is in the Laundry Room

>take shaker
Taken.

you hear the whirring of the dryer.

teddy is in the Laundry Room

>examine shaker
It is empty.

you hear the whirring of the dryer.

teddy is in the Laundry Room

>put teddy in washer
You put Teddy into the washer.

you hear the whirring of the dryer.

teddy is in the Laundry Room

>close washer
You close the washer.

teddy is in the Laundry Room

* * *

>turn on washer
You hear the sloshing of the washer.

teddy is in the Laundry Room

>i
You are carrying:
  Teddy
  a salt shaker

You hear the sloshing of the washer.

teddy is in the Laundry Room

>open dryer
You open the dryer.

You hear the sloshing of the washer.

teddy is in the Laundry Room

* * *

>turn on dryer
you hear the whirring of the dryer.

You hear the sloshing of the washer.

teddy is in the Laundry Room

>i
You are carrying:
  a salt shaker

you hear the whirring of the dryer.

You hear the sloshing of the washer.

teddy is in the Laundry Room

>e
You can't go that way.

you hear the whirring of the dryer.

You hear the sloshing of the washer.

teddy is in the Laundry Room

* * *

>close washer
You close the washer.

teddy is in the Your Bedroom

>turn on washer
You turn the washer on
You hear the sloshing of the washer.

teddy is in the Laundry Room

>wait
Time passes.

You hear the sloshing of the washer.

teddy is in the Laundry Room

>wait
Time passes.

You hear the sloshing of the washer.

teddy is in the Laundry Room

>i
You are carrying:
  Teddy
  a salt shaker

You hear the sloshing of the washer.

teddy is in the Laundry Room

>i
You are carrying:
  Teddy
  a salt shaker

You hear the sloshing of the washer.

teddy is in the Laundry Room

>i
You are carrying:
  Teddy
  a salt shaker

You hear the sloshing of the washer.

teddy is in the Laundry Room
"DING!"
You hear the sound of the washer completing it's cycle.

>open washer
You must wait until the wash cycle is over.

You hear the sloshing of the washer.

teddy is in the Laundry Room

>take boxers
You can't see any such thing.

>i
You are carrying:
  Teddy
  a salt shaker

You hear the sloshing of the washer.

teddy is in the Laundry Room

>look in washer
You can't see inside, since the washer is closed.

You hear the sloshing of the washer.

teddy is in the Laundry Room

>open washer
You must wait until the wash cycle is over.

You hear the sloshing of the washer.

teddy is in the Laundry Room

>switch off washer
You hear the sloshing of the washer.

teddy is in the Laundry Room

* * *

>e
Laundry Room
You can see a washer (closed) and a dryer (closed) here.

DEBUG: Chaser is wandering to the shared bathroom 
DEBUG: teddy acts"Click." 
The lights go off.

 DEBUG: teddy is in the Laundry Room
It is now pitch dark in here!

>cry
Tears well up in your eyes as you sob without restraint.

Mom rushes into the room.

Mom: "What's wrong baby? Are you okay?"

Time passes as Mom soothes you.

mom is light-policing 
mom is locating salt 

Mom goes west.

teddy is in the Your Bedroom

>undo
Laundry Room
[Previous turn undone.]

>s
Garage
mom is light-policing 
mom is locating salt 

teddy is in the Your Bedroom

>cry
Tears well up in your eyes as you sob without restraint.

Mom rushes into the room.

Mom: "What's wrong baby? Are you okay?"

Time passes as Mom soothes you.

mom is light-policing 
mom is locating salt 

Mom goes north.

teddy is in the Your Bedroom

* * *

>e
Laundry Room
You can see a washer (closed) and a dryer (closed) here.

DEBUG: Chaser is wandering to the shared bathroom 
DEBUG: teddy acts"Click." 
The lights go off.

 DEBUG: teddy is in the Laundry Room
It is now pitch dark in here!

>push chair e
Pushing the high chair is difficult and noisy. Time passes.

You push the high chair east to the Garage.

DEBUG: Teddy heard you
Garage

DEBUG: dadvision is empty
DEBUG: dad looking for thingsmom is light-policing 
mom is locating salt 

DEBUG: Mom wanders to the shared bathroom
DEBUG: Teddy's is deciding
 DEBUG: teddy is in the shared bathroom

>push chair w
Pushing the high chair is difficult and noisy. Time passes.

You push the high chair west to the Play Room.

DEBUG: Teddy heard you
Play Room

DEBUG: dadvision is empty
DEBUG: dad looking for thingsDEBUG: Chaser is wandering to the Your Bedroommom is light-policing 
mom is locating salt 

DEBUG: Mom wanders to the Your Bedroom
DEBUG: Teddy's is deciding
 DEBUG: teddy is in the Bobby's Bedroom

>push chair w
Pushing the high chair is difficult and noisy. Time passes.

You push the high chair west to the Entry Hall.

DEBUG: Teddy heard you
Entry Hall
You can see a front door here.

DEBUG: dadvision is empty
DEBUG: dad looking for thingsmom is light-policing 
mom is locating salt 

DEBUG: Mom wanders to the shared bathroom
DEBUG: Teddy's is deciding
 DEBUG: teddy is in the Entry Hall

>push chair w
Pushing the high chair is difficult and noisy. Time passes.

You push the high chair west to the Bobby's Bedroom.

DEBUG: Teddy heard you
Bobby's Bedroom
You can see a step stool and a toybox (closed) here.

DEBUG: dadvision is empty
DEBUG: dad looking for thingsmom is light-policing 
mom is locating salt 

Mom arrives from the west.

DEBUG: Mom wanders to the Bobby's Bedroom
DEBUG: Teddy's is deciding
 DEBUG: teddy is in the Bobby's Bedroom

>push chair w
Pushing the high chair is difficult and noisy. Time passes.

You push the high chair west to the shared bathroom.

DEBUG: Teddy heard you
shared bathroom
I share this bathroom with my brother, Bobby.

You can see a mirror here.

DEBUG: dadvision is empty
DEBUG: dad looking for thingsDEBUG: Chaser is wandering to the Bobby's Bedroom
DEBUG: Teddy's is deciding 
DEBUG: teddy acts
 DEBUG: teddy is in the shared bathroom

>push hcair n
You can't see any such thing.

>push chair n
Pushing the high chair is difficult and noisy. Time passes.

You push the high chair north to the Your Bedroom.

DEBUG: Teddy heard you
Your Bedroom
This is your bedroom. There is a shelf with nothing on it.

You can see dad, a widget, your bed and a dresser here.

DEBUG: dadvision is empty
DEBUG: dad looking for things
DEBUG:adding high chair to dadvision
DEBUG: the stating position of high chair is the Play Room
Dad goes east, pushing the high chair away.

mom is light-policing 
mom is locating salt 

DEBUG: Mom wanders to the shared bathroom
DEBUG: Teddy's is deciding
 DEBUG: teddy is in the Your Bedroom

>e
Small Hall
You can see a high chair, dad and a hall closet (closed) here.

DEBUG: dadvision is empty
DEBUG: dad looking for things
DEBUG:adding high chair to dadvision
DEBUG: the stating position of high chair is the Play Room
Dad goes east, pushing the high chair away.

mom is light-policing 
mom is locating salt 

DEBUG: Mom wanders to the Bobby's Bedroom
DEBUG: Teddy's is deciding
 DEBUG: teddy is in the Small Hall

>e
Living Room
You can see a high chair, dad and bobby here.

DEBUG: dadvision is empty
DEBUG: dad looking for things
DEBUG:adding high chair to dadvision
DEBUG: the stating position of high chair is the Play Room
Dad goes east, pushing the high chair away.

DEBUG: Teddy's is deciding
 DEBUG: teddy is in the Living Room

>e
Laundry Room
You can see a high chair, dad, a hamper (empty), a dog bed (on which is a rubber ball), a washer (closed) and a dryer (closed) here.

DEBUG: dadvision is empty
DEBUG: dad looking for things
DEBUG:adding high chair to dadvision
DEBUG: the stating position of high chair is the Play Room

DEBUG: Teddy's is deciding
 DEBUG: teddy is in the Laundry Room

>wait
Time passes.

DEBUG: dadvision is empty
DEBUG: dad looking for things
DEBUG:adding high chair to dadvision
DEBUG: the stating position of high chair is the Play Room
mom is light-policing 
mom is locating salt 

DEBUG: Mom wanders to the Entry Hall
DEBUG: Teddy's is deciding
 DEBUG: teddy is in the Laundry Room

>e
You can't go that way.

DEBUG: dadvision is empty
DEBUG: dad looking for things
DEBUG:adding high chair to dadvision
DEBUG: the stating position of high chair is the Play Room
DEBUG: Chaser is wandering to the Bobby's Bedroom
DEBUG: Teddy's is deciding
 DEBUG: teddy is in the Laundry Room

>l
Laundry Room
You can see a high chair, dad, a hamper (empty), a dog bed (on which is a rubber ball), a washer (closed) and a dryer (closed) here.

DEBUG: dadvision is empty
DEBUG: dad looking for things
DEBUG:adding high chair to dadvision
DEBUG: the stating position of high chair is the Play Room
DEBUG: Chaser is wandering to the Your Bedroommom is light-policing 
mom is locating salt 

DEBUG: Mom wanders to the Bobby's Bedroom
DEBUG: Teddy's is deciding 
DEBUG: teddy acts"Click." 
The lights go off.

 DEBUG: teddy is in the Laundry Room
It is now pitch dark in here!

>n
Dining Room
You can see a table here.

DEBUG: dadvision is empty
DEBUG: dad looking for things
DEBUG:adding high chair to dadvision
DEBUG: the stating position of high chair is the Play Room

DEBUG: Teddy's is deciding
 DEBUG: teddy is in the Dining Room

>s
Darkness
It is pitch dark, and you can't see a thing.

DEBUG: dadvision is empty
DEBUG: dad looking for things
DEBUG:adding high chair to dadvision
DEBUG: the stating position of high chair is the Play Room

DEBUG: Teddy's is deciding
 DEBUG: teddy is in the Laundry Room

>s
Play Room

DEBUG: dadvision is empty
DEBUG: dad looking for things
DEBUG:adding high chair to dadvision
DEBUG: the stating position of high chair is the Play Room
DEBUG: Chaser is wandering to the Bobby's Bedroom
DEBUG: Teddy's is deciding
 DEBUG: teddy is in the Play Room

>n
Darkness
It is pitch dark, and you can't see a thing.

DEBUG: dadvision is empty
DEBUG: dad looking for things
DEBUG:adding high chair to dadvision
DEBUG: the stating position of high chair is the Play Room

DEBUG: Teddy's is deciding
 DEBUG: teddy is in the Laundry Room

>push high chairs
You can't see any such thing.

>push high char s
You can't see any such thing.

>push chair s
You can't see any such thing.

* * *

>e
Living Room
You can see a high chair here.

 DEBUG: teddy is in the Your Bedroom

>s
Entry Hall
You can see Bobby and a front door here.

teddy is in the Your Bedroom

>s
(first opening the front door)
Your mom has installed a child-proof lock on the front door for your safety.

teddy is in the Your Bedroom

>w
You can't go that way.

Mom

>n
Living Room
Mom

>n
Kitchen
You can see a pantry (closed) here.

Momactother alonedarkkilledone

>n
You can't go that way.

>e
Dining Room
You can see a table and a high chair here.

>e
You can't go that way.

actother numberdarkchase

>w
Kitchen
You can see a pantry (closed) here.

>w
You can't go that way.

actother numberlitwander

>n
You can't go that way.

>w
You can't go that way.

actother numberdarkchase

>e
Dining Room
You can see a table and a high chair here.

>n
You can't go that way.

actother numberlitlightsgoout

>e
You can't go that way.

>w
Kitchen
You can see a pantry (closed) here.

actother numberdarkchase

>w
You can't go that way.

>w
You can't go that way.

>s
Living Room
yourselfactyou alonelitnot carried

>e
Laundry Room
You can see a dryer (closed) and a washer (closed) here.

yourself

>n
Dining Room
You can see a table and a high chair here.

yourselfactyou alonelitcarried"Click." 
The lights go off.

It is now pitch dark in here!

* * *

>s
(first opening the front door)
Your mom has installed a child-proof lock on the front door for your safety.

teddy is in the Your Bedroom

>e
You can't go that way.

Mom

>w
You can't go that way.

actother numberlitlightsgoout

>n
Living Room
You can see a roomba here.

actother numberdarkchase

* * *

>e
You can't go that way.

Mom

>n
Living Room
Mom

>n
Kitchen
You can see a pantry (closed) here.

Mom

>n
You can't go that way.

Mom

>w
You can't go that way.

Mom

>e
Dining Room
You can see a table and a high chair here.

Mom

>s
Laundry Room
You can see a dryer (closed) and a washer (closed) here.

Mom

>s
Garage
Mom

>s
You can't go that way.

Mom

>n
Laundry Room
You can see a dryer (closed) and a washer (closed) here.

Mom

>e
You can't go that way.

Mom

>w
Living Room
Mom

* * *

>s
(first opening the front door)
Your mom has installed a child-proof lock on the front door for your safety.

teddy is in the Your Bedroom

>open front door
Your mom has installed a child-proof lock on the front door for your safety.

mom is light-policing 
mom is locating salt 
teddy is in the Your Bedroom

* * *

>s
Entry Hall
You can see Bobby and a front door here.

teddy is in the Your Bedroom

>cry
Tears well up in your eyes as you sob without restraint.

Mom rushes into the room.

Mom: "What's wrong baby? Are you okay?"

Time passes as Mom soothes you.

mom is light-policing 
mom is locating salt 

Mom goes north.

teddy is in the Your Bedroom

>undo
entry hall
[Previous turn undone.]

* * *

>s
Entry Hall
You can see Bobby and a front door here.

teddy is in the Your Bedroom

>open door
A childproof lock prevents your escape.

mom is light-policing 
mom is locating salt 
teddy is in the Your Bedroom

>s
(first opening the front door)
A childproof lock prevents your escape.

teddy is in the Your Bedroom

* * *

>e
Living Room
You can see a high chair here.

 DEBUG: teddy is in the Your Bedroom

>pour salt on ground
You pour the salt on the floor.

turnvaccum timesalted room
actother numberlitlightsgoout

>wait
Time passes.

turn

>wait
Time passes.

turn

>wait
Time passes.

turnvaccum timesalted room

>wait
Time passes.

turnactother numberlitwander

>wait
Time passes.

turn

>wait
Time passes.

turnvaccum timesalted room
Mom arrives from the west.

tryBRRRRRR!
Mom scolds you sternly for spilling salt on her floors, then vacuums up the mess.

* * *

>e
Living Room
You can see a high chair here.

 DEBUG: teddy is in the Your Bedroom

>open dryer
You can't see any such thing.

>e
Laundry Room
You can see a dryer (closed) and a washer (closed) here.

teddy is in the Your Bedroom

>open dryer
You open the dryer.

teddy is in the Your Bedroom

>close dryer
(the dryer)
teddy is in the Your Bedroom

* * *

>close dryer
You close the dryer.

teddy is in the Your Bedroom

>turn on dtryer
You can't see any such thing.

>turn on dryer
You turn the dryer on
teddy is in the Your Bedroom

>open dryer
the dryer is running. You must wait until the cycle is complete.

teddy is in the Your Bedroom

>examine dryer
The dryer is on

teddy is in the Your Bedroom

* * *

>e
Small Hall
You can see a dog bed (on which is a rubber ball), Chaser and a hall closet (closed) here.

 DEBUG: teddy is in the Your Bedroom

>open closet
You open the hall closet, revealing a vacuum cleaner.

mom is light-policing 
mom is locating salt 

teddy is in the Your Bedroom

>e
Living Room

* * *

>e
You can't go that way.

>s
Garage

>e
You can't go that way.

>n
Laundry Room
You can see a dryer (closed) and a washer (closed) here.

actother numberlitwander

>n
Dining Room
You can see a table and a high chair here.

actother numberlitwander

>e
You can't go that way.

>s
Laundry Room
You can see a dryer (closed) and a washer (closed) here.

>e
You can't go that way.

>n
Dining Room
You can see a table and a high chair here.

>e
You can't go that way.

>n
You can't go that way.

>e
You can't go that way.

>w
Kitchen
You can see a pantry (closed) here.

>w
You can't go that way.

>s
Living Room

>w
Small Hall
You can see Mom and a hall closet (in which is a vacuum cleaner) here.

>w
My Bedroom
This is my bedroom. There is a shelf with  a teddy bear on it. 

You can see a kiddie stool here.

yourself

>get on stool
You get onto the kiddie stool.

yourself

>turn on lights
yourself

* * *

>open closet
You open the hall closet, revealing a vacuum cleaner.

mom is light-policing 
mom is locating salt 

teddy is in the Your Bedroom

>take vacuum
Taken.

mom is light-policing 
mom is locating salt 

teddy is in the Your Bedroom

>e
Living Room
turnno vacuume timeMom is wandering
mom wanders

>pour salt on ground
You pour the salt on the floor.

turnvaccum timesalted roomBobby

>wait
Time passes.

turnvaccum timesearch timeBobby

>wait
Time passes.

turnvaccum timesearch timeBobby

>wait
Time passes.

turnvaccum time
Momactother alonelitlightsgoout

>wait
Time passes.

turnvaccum time

>wait
Time passes.

turnvaccum time
Mom

>wait
Time passes.

turnMom

>wait
Time passes.

turnMom

>wait
Time passes.

turnvaccum time

>wait
Time passes.

turn

>wait
Time passes.

turnvaccum time

* * *

>wait
Time passes.

turn

>wait
Time passes.

turnactother numberlitlightsgoout

>wait
Time passes.

turnvaccum time

* * *

>wait
Time passes.

turn

>ACTIONS
Actions listing on.

>wait
[waiting]
Time passes.
[waiting - succeeded]

turn

>wait
[waiting]
Time passes.
[waiting - succeeded]

turn

>wait
[waiting]
Time passes.
[waiting - succeeded]

turnactother numberlitwander

>wait
[waiting]
Time passes.
[waiting - succeeded]

turn

>wait
[waiting]
Time passes.
[waiting - succeeded]

turnvaccum time

>wait
[waiting]
Time passes.
[waiting - succeeded]

turnvaccum time
[Mom going north]
[Mom going north - succeeded]

Mom

>wait
[waiting]
Time passes.
[waiting - succeeded]

turnMom

>wait
[waiting]
Time passes.
[waiting - succeeded]

turnMom

>wait
[waiting]
Time passes.
[waiting - succeeded]

turnMomactother alonelitlightsgoout

* * *

>wait
Time passes.

turnvaccum timesearch timeBobby

>e
Laundry Room
You can see a dryer (closed) and a washer (closed) here.

turnvaccum timesearch timeBobbyactother alonelitlightsgoout

>e
You can't go that way.

turnvaccum timesearch timeBobby

>w
Living Room
turnvaccum timesearch timeBobby

>s
entry hall
You can see Bobby here.

turnvaccum timesearch timeyourself and Bobby

>e
You can't go that way.

turnvaccum timesearch timeyourself and Bobby

>e
You can't go that way.

turnvaccum timesearch timeyourself and Bobby

>n
Living Room
turnvaccum timesearch timeBobby

>e
Laundry Room
You can see a dryer (closed) and a washer (closed) here.

turnvaccum timesearch timeBobby

>w
Living Room
turnvaccum timesearch timeBobby

>w
Small Hall
You can see Mom and a hall closet (empty) here.

turnvaccum timesearch timeMom: What are you doing with the vacuum cleaner? That isn't a toy! Give it to me!

Mom takes the vacuum from you.
Bobby

* * *

>e
Living Room
turnno vacuume timeMom is wandering
mom wanders

>s
entry hall
You can see Bobby here.

turnno vacuume timeMom is wandering
mom wanders

>s
You can't go that way.

turnno vacuume timeMom is wandering
mom wanders

>pour salt on ground
You pour the salt on the floor.

turnvaccum timesalted room

>l
entry hall
You can see Bobby here.

turnvaccum timesalted room

>wait
Time passes.

turnvaccum timesearch timeMom is wandering

>wait
Time passes.

turnvaccum timesearch timeMom is wandering

>wait
Time passes.

turnvaccum timesearch timeMom is wanderingactother numberlitlightsgoout

>wait
Time passes.

turnvaccum timesearch timeMom is wandering

>wait
Time passes.

turnvaccum timesearch timeMom is wandering
Mom

>e
You can't go that way.

turnvaccum timesearch timeMom is wandering
actother numberlitwanderTeddy is wandering

>n
Living Room
turnvaccum timesearch timeMom is wandering

>e
Laundry Room
You can see a dryer (closed) and a washer (closed) here.

turnvaccum timesearch timeMom is wanderingactother numberlitwanderTeddy is wandering

>w
Living Room
turnvaccum timesearch timeMom is wandering

>w
Small Hall
You can see a hall closet (empty) here.

turnvaccum timesearch timeMom is wandering
Mom arrives from the west.

Mom and yourself

>wait
Time passes.

turnvaccum timesearch timeMom: What are you doing with the vacuum cleaner? That isn't a toy! Give it to me!

Mom takes the vacuum from you.
Mom and yourselfacttwolitnot carried

>wait
Time passes.

turnvaccum timesalted room
Mom goes east.

tryyourself

>wait
Time passes.

turnvaccum timesalted room
tryYou hear the whirring of a vacuum cleaner some distance away.
yourselfactyou alonelitcarried

* * *

>take vacuum
Taken.

mom is light-policing 
mom is locating salt 

teddy is in the Your Bedroom

>close closet
You close the hall closet.

mom is light-policing 
mom is locating salt 

Mom arrives from the west.

teddy is in the Shared Bathroom

>w
Your Bedroom
This is your bedroom. There is a shelf with nothing on it.

You can see Mom, a kiddie stool, your bed and a dresser here.

mom turn

>pour salt on ground
You pour the salt on the floor.

mom turnmom notices the salt in the Your Bedroomgetting vacuumYour Bedroom
Mom goes east.

>wait
Time passes.

mom turngetting vacuumYour Bedroom

>wait
Time passes.

mom turngetting vacuumYour Bedroom

>w
You can't go that way.

mom turngetting vacuumYour Bedroom

>e
Small Hall
You can see Mom and a hall closet (closed) here.

mom turngetting vacuumYour Bedroom
Mom opens the hall closet.

Mom: "Where's the vacuum cleaner?"
Mom closes the hall closet.

* * *

>close closet
You close the hall closet.

mom is light-policing 
mom is locating salt 

Mom arrives from the west.

teddy is in the Shared Bathroom

>wait
Time passes.

mom turn

>w
Your Bedroom
This is your bedroom. There is a shelf with nothing on it.

You can see Mom, a kiddie stool, your bed and a dresser here.

mom turn

* * *

>pour salt on ground
You pour the salt on the floor.

mom turnmom notices the salt in the Your Bedroomgetting vacuumYour Bedroom
Mom goes east.

>e
Small Hall
You can see Mom and a hall closet (closed) here.

mom turngetting vacuumYour Bedroom
Mom opens the hall closet.

Mom closes the hall closet.

Mom is wandering
Mom goes west.

>wait
Time passes.

mom turnmom notices the salt in the Your Bedroomgetting vacuumYour Bedroom
Mom arrives from the west.

>wait
Time passes.

mom turngetting vacuumYour Bedroom
Mom opens the hall closet.

Mom closes the hall closet.

Mom is wandering
Mom goes west.

* * *

>close closet
You close the hall closet.

mom is light-policing 
mom is locating salt 

Mom arrives from the west.

teddy is in the Shared Bathroom

>pour salt on ground
You pour some salt on the floor
the Small Hall is salted.

mom is light-policing 
mom is locating salt 
mom sees the salt in Small Hall
mom is vacuum-fetching
mom is fetching the vacuum 

Mom opens the hall closet.

Mom: Where is the vacuum cleaner?
mom is vacuum-seeking. 

Mom closes the hall closet.

teddy is in the Shared Bathroom

>wait
Time passes.

mom is light-policing 
mom is locating salt 
mom sees the salt in Small Hall
mom will continue her current task for now

Mom goes west.

teddy is in the Shared Bathroom

* * *

>take vacuum
Taken.

mom is light-policing 
mom is locating salt 

teddy is in the Your Bedroom

>close vacuum
It isn't something you can close.

mom is light-policing 
mom is locating salt 

teddy is in the Your Bedroom

>pour salt on ground
You pour some salt on the floor
the Small Hall is salted.

mom is light-policing 
mom is locating salt 

teddy is in the Your Bedroom

>wait
Time passes.

mom is light-policing 
mom is locating salt 

teddy is in the Your Bedroom

>wait
Time passes.

mom is light-policing 
mom is locating salt 

Mom arrives from the west.

teddy is in the Your Bedroom

>wait
Time passes.

mom is light-policing 
mom is locating salt 
mom sees the salt in Small Hall
mom is vacuum-fetching
mom is fetching the vacuum 

Mom: Where is the vacuum cleaner?
mom is vacuum-seeking. 

Mom closes the hall closet.

teddy is in the Your Bedroom

>wait
Time passes.

mom is light-policing 
mom is locating salt 
mom sees the salt in Small Hall
mom is vacuum-seeking

Mom goes west.

teddy is in the Your Bedroom

* * *

>take vacuum
Taken.

mom is light-policing 
mom is locating salt 

teddy is in the Your Bedroom

>pour salt on ground
You pour some salt on the floor
the Small Hall is salted.

mom is light-policing 
mom is locating salt 
mom sees the salt in Small Hall
mom is vacuum-fetching
mom is fetching the vacuum 

Mom: Where is the vacuum cleaner?
mom is vacuum-seeking. 

Mom closes the hall closet.

teddy is in the Your Bedroom

>wait
Time passes.

mom is light-policing 
mom is locating salt 
mom sees the salt in Small Hall
mom is vacuum-seeking
You took my vacuum cleaner!
Mom takes the vacuum from you and puts you in time-out
Your Bedroom
This is your bedroom. There is a shelf with a teddy bear on it. 

You can see a kiddie stool, your bed and a dresser here.

mom is vacuum-doing

teddy is in the Your Bedroom
Your mother has locked you in your room for a 10-minute time-out.

>wait
Time passes.

mom is light-policing 
mom is locating salt 
mom sees the salt in Small Hall
mom is vacuum-doing
BRRR! You hear the vacuum cleaner
teddy is in the Your Bedroom

>wait
Time passes.

mom is light-policing 
mom is locating salt 
mom is returning the vacuum

teddy is in the Your Bedroom

>wait
Time passes.

mom is light-policing 
mom is locating salt 

teddy is in the Your Bedroom

>wait
Time passes.

mom is light-policing 
mom is locating salt 

teddy is in the Your Bedroom

>s
You can't go that way.

mom is light-policing 
mom is locating salt 

teddy is in the Your Bedroom

>e
You can't go that way.

mom is light-policing 
mom is locating salt 

teddy is in the Your Bedroom

>s
You can't go that way.

mom is light-policing 
mom is locating salt 

teddy is in the Your Bedroom

I beg your pardon?

>e
You can't go that way.

mom is light-policing 
mom is locating salt 

teddy is in the Small Hall
Your Bedroom
This is your bedroom. There is a shelf withnothing on it.

You can see a kiddie stool, your bed and a dresser here.

time out is over

* * *

>wait
Time passes.

mom is light-policing 
mom is locating salt 
mom sees the salt in Small Hall
mom is vacuum-seeking
You took my vacuum cleaner!
Mom takes the vacuum from you and puts you in time-out
Your Bedroom
This is your bedroom. There is a shelf with a teddy bear on it. 

You can see a kiddie stool, your bed and a dresser here.

mom is vacuum-doing

teddy is in the Your Bedroom
Your mother has locked you in your room for a 10-minute time-out.

>i
You are carrying:
  a lucky boxers
  a salt shaker

mom is light-policing 
mom is locating salt 
mom sees the salt in Small Hall
mom is vacuum-doing
BRRR! You hear the vacuum cleaner
teddy is in the Your Bedroom

>s
You cannot leave your room during time-out.

mom is light-policing 
mom is locating salt 
mom is returning the vacuum

teddy is in the Your Bedroom

>l
Your Bedroom
This is your bedroom. There is a shelf withnothing on it.

You can see a kiddie stool, your bed and a dresser here.

mom is light-policing 
mom is locating salt 

Mom arrives from the east.

teddy is in the Your Bedroom

>wait
Time passes.

mom is light-policing 
mom is locating salt 

Mom goes south.

teddy is in the Your Bedroom

>e
You cannot leave your room during time-out.

mom is light-policing 
mom is locating salt 

teddy is in the Your Bedroom

>wait
Time passes.

mom is light-policing 
mom is locating salt 

Mom arrives from the south.

teddy is in the Your Bedroom

>l
Your Bedroom
This is your bedroom. There is a shelf withnothing on it.

You can see Mom, a kiddie stool, your bed and a dresser here.

mom is light-policing 
mom is locating salt 

Mom goes south.

teddy is in the Your Bedroom

* * *

>take vacuum
Taken.

mom is light-policing 
mom is locating salt 

teddy is in the Your Bedroom

>pour salt on rug
You can't see any such thing.

>pour salt on floor
You pour some salt on the floor
the Small Hall is salted.

mom is light-policing 
mom is locating salt 

teddy is in the Your Bedroom

>wait
Time passes.

mom is light-policing 
mom is locating salt 

teddy is in the Your Bedroom

>w
Darkness
It is pitch dark, and you can't see a thing.

mom is light-policing 
Mom: Who keeps turning off the lights?

Exasperated, Mom switches on the lights.
"Click." 
The lights go on.
mom is locating salt 

teddy is in the Your Bedroom
Your Bedroom
This is your bedroom. There is a shelf with a teddy bear on it. 

You can see a kiddie stool, your bed and a dresser here.

>e
Small Hall
You can see a hall closet (empty) here.

mom is light-policing 
mom is locating salt 

teddy is in the Your Bedroom

>s
Bobby's Bedroom
You can see a toybox (closed) here.

mom is light-policing 
mom is locating salt 

teddy is in the Your Bedroom

* * *

>take vacuum
Taken.

mom is light-policing 
mom is locating salt 

teddy is in the Your Bedroom

>take vacuum
You already have that.

mom is light-policing 
mom is locating salt 

teddy is in the Your Bedroom

>pour salt on ground
You pour some salt on the floor
the Small Hall is salted.

mom is light-policing 
mom is locating salt 

teddy is in the Your Bedroom

>wait
Time passes.

mom is light-policing 
mom is locating salt 

teddy is in the Living Room

>w
Darkness
It is pitch dark, and you can't see a thing.

mom is light-policing 
mom is locating salt 

teddy is in the Living Room

>e
Small Hall
You can see a hall closet (empty) here.

mom is light-policing 
mom is locating salt 

teddy is in the Living Room

>s
Bobby's Bedroom
You can see a toybox (closed) here.

mom is light-policing 
mom is locating salt 

teddy is in the Living Room

>n
Small Hall
You can see a hall closet (empty) here.

mom is light-policing 
mom is locating salt 

teddy is in the Living Room

>e
Living Room
mom is light-policing 
mom is locating salt 

teddy is in the Living Room

>e
Laundry Room
You can see a washer (closed) and a dryer (closed) here.

mom is light-policing 
mom is locating salt 
mom sees the salt in Small Hall
mom is vacuum-fetching
mom is fetching the vacuum 

Mom: Where is the vacuum cleaner?
mom is vacuum-seeking. 

teddy is in the Living Room

>w
Living Room
mom is light-policing 
mom is locating salt 
mom sees the salt in Small Hall
mom is vacuum-seeking
You took my vacuum cleaner!
Mom takes the vacuum from you and puts you in time-out
Your Bedroom
This is your bedroom. There is a shelf with nothing on it.

You can see a kiddie stool, your bed and a dresser here.

mom is vacuum-doing

teddy is in the Living Room
Your mother has locked you in your room for a 10-minute time-out.

>wait
Time passes.

mom is light-policing 
mom is locating salt 
mom sees the salt in Small Hall
mom is vacuum-doing
BRRR! You hear the vacuum cleaner
teddy is in the Small Hall

>wait
Time passes.

mom is light-policing 
mom is locating salt 
mom is returning the vacuum

teddy is in the Small Hall

>wait
Time passes.

mom is light-policing 
mom is locating salt 

teddy is in the Small Hall

>s
You cannot leave your room during time-out.

mom is light-policing 
mom is locating salt 

teddy is in the Small Hall

* * *

>e
Small Hall
You can see a dog bed (on which is a rubber ball), Chaser and a hall closet (closed) here.

 DEBUG: teddy is in the Your Bedroom

>wait
Time passes.

Mom retrieves the vacuum from the cabinet

* * *

>e
Small Hall
You can see a dog bed (on which is a rubber ball), Chaser and a hall closet (closed) here.

 DEBUG: teddy is in the Your Bedroom

>w
Your Bedroom
This is your bedroom. There is a shelf with  a teddy bear on it. 

You can see Mom, a kiddie stool, your bed, a dresser and a your bed here.

teddy is in the Your Bedroom

>push stool e
Pushing the kiddie stool is difficult and noisy. Time passes.

You push the kiddie stool east to the Small Hall.

increase : 1
turnno vacuume time
The current speed of Teddy is 20

>eait
That's not a verb I recognise.

>wait
Time passes.

turnno vacuume time
The current speed of Teddy is 20

>wait
Time passes.

turnno vacuume time
mom wanders
The current speed of Teddy is 20

>wait
Time passes.

turnno vacuume time
The current speed of Teddy is 20
0

>wait
Time passes.

turnno vacuume time
The current speed of Teddy is 15

* * *

>w
Your Bedroom
This is your bedroom. There is a shelf with  a teddy bear on it. 

You can see Mom, a kiddie stool, your bed, a dresser and a your bed here.

teddy is in the Your Bedroom

>pour salt on ground
You pour the salt on the floor.

mom turnmom notices the salt in the Your Bedroomgetting vacuumYour Bedroom
Mom goes east.

>e
Small Hall
You can see Mom and a hall closet (closed) here.

mom turngetting vacuumYour Bedroom
Mom opens the hall closet.

Mom picks up the vacuum cleaner.

Mom closes the hall closet.

>wait
Time passes.

mom turn
Mom goes west.

>wait
Time passes.

mom turnmom notices the salt in the Your Bedroommom vacuums the saltentry 1 of momvision is gone

>w
Your Bedroom
This is your bedroom. There is a shelf with nothing on it.

You can see Mom, a kiddie stool, your bed and a dresser here.

mom turn

>e
Small Hall
You can see a hall closet (closed) here.

mom turn

>open closet
You open the hall closet.

mom turn

>take vacuum
You can't see any such thing.

* * *

>w
Your Bedroom
This is your bedroom. There is a shelf with  a teddy bear on it. 

You can see Mom, a kiddie stool, your bed, a dresser and a your bed here.

teddy is in the Your Bedroom

>take teddy
Taken.

teddy is in the Your Bedroom

>e
Small Hall
You can see a hall closet (closed) here.

teddy is in the Small Hall

>e
Living Room
teddy is in the Living Room

>e
Laundry Room
You can see a washer (closed) and a dryer (closed) here.

teddy is in the Laundry Room

>put teddy in washer
The washer is closed.

teddy is in the Laundry Room

* * *

>open washer
You open the washer.

teddy is in the Laundry Room

>put teddy in washer
teddy is in nothing

>examine washer
The washer is off.

teddy is in nothing

>look in washer
The washer is empty.

teddy is in nothing

* * *

>e
Small Hall
You can see a dog bed (on which is a rubber ball), Chaser and a hall closet (closed) here.

 DEBUG: teddy is in the Your Bedroom

>open cabinet
You can't see any such thing.

>open closet
You open the hall closet, revealing a vacuum cleaner.

turnno vacuume timeMom is wanderingmom wandersactother numberlitlightsgoout

>take vacuum
Taken.

turnno vacuume timeMom is wandering
Mom goes west.

mom wanders

>e
Living Room
turnno vacuume timeactother numberlitwander

>put vacuum on stool
You can't see any such thing.

>w
Small Hall
You can see a hall closet (empty) here.

turnno vacuume timemom wanders

>w
Your Bedroom
This is your bedroom. There is a shelf with nothing on it.

You can see a kiddie stool, your bed and a dresser here.

turnno vacuume time

>put vacuum on stool
The vacuum awkwardly falls to the ground.

turnno vacuume time

>pick up vacuum
Taken.

turnno vacuume time

>get on stool
You get onto the kiddie stool.

turnno vacuume time
Mom goes north.

mom wandersyourself

>drop vacuum
Dropped.

turnno vacuume timeyourself

>l
Your Bedroom (on the kiddie stool)
This is your bedroom. There is a shelf with nothing on it.

You can see a vacuum cleaner, Mom, your bed and a dresser here.

turnno vacuume timeyourself

>pour salt on ground
You pour the salt on the floor.

turnyourself

>wait
Time passes.

turnvaccum timesalted room
Mom goes east.

yourselfactyou alonelitnot carried

>e
(first getting off the kiddie stool)

Small Hall
You can see Mom and a hall closet (empty) here.

turnvaccum timesalted roomMom: "Where's the vacuum?"yourself and MomacttwolitcarriedThe lights are already off.
lightsgoout

* * *

>take vacuum
Taken.

turnno vacuume timeMom is wandering
Mom goes west.

mom wanders

>s
Bobby's Bedroom
You can see a toybox (closed) here.

turnno vacuume timeMom is wandering
mom wanders

>pour salt on ground
You pour the salt on the floor.

turnvaccum timesalted roomactother numberlitlightsgoout

>wait
Time passes.

turnvaccum timesearch timeMom is wandering
actother numberlitlightsgoout

>wait
Time passes.

turnvaccum timesearch timeMom is wandering

>n
Small Hall
You can see Mom and a hall closet (empty) here.

turnvaccum timesearch timeMom: What are you doing with the vacuum cleaner? That isn't a toy! Give it to me!

Mom takes the vacuum from you.
actother numberlitlightsgoout

>i
You are carrying:
  a salt shaker

turnvaccum timesearch timeMom: THERE'S the vacuum cleaner! How did it get out here?

Mom takes the vacuum.

* * *

>open closet
You open the hall closet, revealing a vacuum cleaner.

turnno vacuume timeMom is wanderingmom wandersactother numberlitlightsgoout

>take vacuume
You can't see any such thing.

>take vacuum
Taken.

turnno vacuume time

>e
Living Room
turnno vacuume time

>i
You are carrying:
  a vacuum cleaner
  a salt shaker

turnno vacuume timeactother numberlitwander

>pour salt on ground
You pour the salt on the floor.

turnno vacuume time

>wait
Time passes.

turnno vacuume time

>wait
Time passes.

turnno vacuume time

>wait
Time passes.

turnno vacuume timemom wanders

* * *

>e
Small Hall
You can see a dog bed (on which is a rubber ball), Chaser and a hall closet (closed) here.

 DEBUG: teddy is in the Your Bedroom

>take vacuum
You can't see any such thing.

>open closet
You open the hall closet, revealing a vacuum cleaner.

turnno vacuume timeMom is wanderingmom wanders

>take vacuum
Taken.

turnno vacuume timeMom is wanderingmom wanders

>w
Your Bedroom
This is your bedroom. There is a shelf with nothing on it.

You can see Mom, a kiddie stool, your bed and a dresser here.

turnno vacuume time

>pour salt
What do you want to pour salt on?

>ground
You pour the salt on the floor.

turn

>wait
Time passes.

turn

>wait
Time passes.

turnactother numberlitwander

* * *

>wait
Time passes.

turn

>l
Your Bedroom
This is your bedroom. There is a shelf with nothing on it.

You can see Mom, a kiddie stool, your bed and a dresser here.

turnvaccum timesalted room
Mom goes east.

>e
Small Hall
You can see Mom and a hall closet (empty) here.

turnvaccum timesalted roomMom: "Where's the vacuum?"

>wait
Time passes.

turnvaccum time
Mom goes west.

>w
Your Bedroom
This is your bedroom. There is a shelf with nothing on it.

You can see Mom, a kiddie stool, your bed and a dresser here.

turnvaccum time
Mom goes south.

actother numberlitwander

>l
Your Bedroom
This is your bedroom. There is a shelf with nothing on it.

You can see a kiddie stool, your bed and a dresser here.

turn

>pour salt on ground
You pour the salt on the floor.

turn

>wait
Time passes.

turnvaccum time
Mom arrives from the south.

actother numberlitwander

>wait
Time passes.

turn

>wait
Time passes.

turnvaccum time
Mom goes south.

actother numberlitwander

>wait
Time passes.

turn

>s
Shared Bathroom
I share this bathroom with my brother, Bobby.

You can see Mom and a mirror here.

turn

>wait
Time passes.

turnvaccum time

>wait
Time passes.

turnactother numberlitlightsgoout

>wait
Time passes.

turn

* * *

>ACTIONS
Actions listing on.

>wait
[waiting]
Time passes.
[waiting - succeeded]

turnactother numberlitwander[Teddy going south - silently]
[Teddy going south - silently - succeeded]

>wait
[waiting]
Time passes.
[waiting - succeeded]

turnvaccum time
[Mom going north]
Mom goes north.
[Mom going north - succeeded]

>N
[going north]

Your Bedroom
This is your bedroom. There is a shelf with nothing on it.

You can see Mom, a kiddie stool, your bed and a dresser here.

[going north - succeeded]

turnvaccum time
[Mom going east]
Mom goes east.
[Mom going east - succeeded]

Mom

>E
[going east]

Small Hall
You can see Mom and a hall closet (empty) here.

[going east - succeeded]

turnvaccum time
[Mom going west]
Mom goes west.
[Mom going west - succeeded]

yourself

>W
[going west]

Your Bedroom
This is your bedroom. There is a shelf with nothing on it.

You can see Mom, a kiddie stool, your bed and a dresser here.

[going west - succeeded]

turnvaccum time
[Mom going south]
Mom goes south.
[Mom going south - succeeded]

actother numberlitwander

* * *

>take vacuum
Taken.

turnno vacuume timeMom is wanderingmom wanders

>e
Living Room
turnno vacuume timeMom is wanderingmom wanders

>e
Laundry Room
You can see a dryer (closed) and a washer (closed) here.

turnno vacuume timeMom is wanderingmom wanders

>s
Garage
turnno vacuume timeMom is wanderingmom wanders

>pour salt on ground
You pour the salt on the floor.

turnvaccum timesalted room

>ACTIONS
Actions listing on.

>WAIT
[waiting]
Time passes.
[waiting - succeeded]

turnvaccum timesearch timeactother numberlitlightsgoout

>WAIT
[waiting]
Time passes.
[waiting - succeeded]

turnvaccum timesearch time

>WAIT
[waiting]
Time passes.
[waiting - succeeded]

turnvaccum timesearch time

>WAIT
[waiting]
Time passes.
[waiting - succeeded]

turnvaccum timesearch timeactother numberlitwanderTeddy is wandering[Teddy going west - silently]
[Teddy going west - silently - succeeded]

>WAIT
[waiting]
Time passes.
[waiting - succeeded]

turnvaccum timesearch time

>WAIT
[waiting]
Time passes.
[waiting - succeeded]

turnvaccum timesearch timeactother numberlitlightsgoout

>WAIT
[waiting]
Time passes.
[waiting - succeeded]

turnvaccum timesearch timeactother numberlitwanderTeddy is wandering

>WAIT
[waiting]
Time passes.
[waiting - succeeded]

turnvaccum timesearch time

* * *

>e
Small Hall
You can see a dog bed (on which is a rubber ball), Chaser and a hall closet (closed) here.

 DEBUG: teddy is in the Your Bedroom

>pour salt on ground
You pour the salt on the floor.

mom turnsaltedmom sees: Small Hallactother numberlitwanderTeddy is wandering

>wait
Time passes.

turnno vacuume timeMom is wandering
mom wandersactother numberlitlightsgoout

>wait
Time passes.

turnno vacuume timeMom is wandering
mom wandersactother numberlitlightsgoout

>wait
Time passes.

turn

>e
Living Room
turnno vacuume timeMom is wandering
mom wandersyourself

>pour salt in ground
I didn't understand that sentence.

>pour salt
(on the salt shaker)
That doesn't need to be salty.

turnno vacuume timeMom is wandering
mom wandersyourself

Glulxe fatal error: Stack overflow in callstub.

* * *

>wait
Time passes.

turnno vacuume timeMom is wandering
mom wandersactother numberlitlightsgoout

>e
Living Room
turnyourself

>pour salt on ground
You pour the salt on the floor.

turnTeddy is wandering

>wait
Time passes.

turn

>e
Laundry Room
You can see a dryer (closed) and a washer (closed) here.

turnyourself

>w
Living Room
turn

>w
Small Hall
You can see Mom and a hall closet (closed) here.

turn

>wait
Time passes.

turn

* * *

>pour salt on ground
You pour the salt on the floor.

mom turnsaltedmom sees: Small Hallactother numberlitwanderTeddy is wandering

>s
Bobby's Bedroom
You can see a toybox (closed) here.

mom turnvaccum timesalted roomdecided to vacuum

>pour salt on ground
You pour the salt on the floor.

mom turnvaccum timesalted roommom sees: Small Hallsalt path is nothing, vacuum time now falsedecided to vacuum

>w
Shared Bathroom
I share this bathroom with my brother, Bobby.

You can see a mirror here.

mom turnsaltedmom sees: Small Hallyourself

>pour salt on ground
You pour the salt on the floor.

mom turnvaccum timesalted roommom sees: Small Hallsalt path is nothing, vacuum time now falsedecided to vacuumTeddy is wandering

* * *

>e
Small Hall
You can see a dog bed (on which is a rubber ball), Chaser and a hall closet (closed) here.

 DEBUG: teddy is in the Your Bedroom

>s
Bobby's Bedroom
You can see a toybox (closed) here.

mom turnno vacuume timeMom is wanderingmom wandersMom

>pour salt on ground
You pour the salt on the floor.

mom turnno vacuume timeMom is wandering
mom wanders

>n
Small Hall
You can see a hall closet (closed) here.

mom turnno vacuume timeMom is wandering
mom wandersyourself

>e
Living Room
mom turnno vacuume timeMom is wanderingmom wandersactother numberlitlightsgoout

>pour salt on ground
You pour the salt on the floor.

mom turnno vacuume timeMom is wandering
mom wanders

>n
Kitchen
You can see a pantry (closed) here.

mom turnno vacuume timeMom is wandering
mom wandersMomactother alonelitlightsgoout

>pour salt on ground
You pour the salt on the floor.

mom turnno vacuume timeMom is wandering
mom wanders

>wait
Time passes.

mom turnno vacuume timeMom is wandering
mom wanders

>s
Living Room
mom turnno vacuume timeMom is wandering
mom wanders

>e
Laundry Room
You can see a dryer (closed) and a washer (closed) here.

mom turnno vacuume timeMom is wandering
mom wandersactother numberlitwanderTeddy is wandering

>wait
Time passes.

mom turnno vacuume timeMom is wanderingmom wandersactother numberlitlightsgoout

>wait
Time passes.

mom turnno vacuume timeMom is wandering
mom wandersMom

>wait
Time passes.

mom turnno vacuume timeMom is wandering
mom wanders

>wait
Time passes.

mom turnno vacuume timeMom is wandering
mom wandersMom

>w
Living Room
mom turnno vacuume timeMom is wandering
mom wanders

>w
Small Hall
You can see a hall closet (closed) here.

mom turnno vacuume timeMom is wandering
mom wandersMom

>pour salt on ground
You pour the salt on the floor.

mom turnno vacuume timeMom is wandering
mom wanders

>w
Your Bedroom
This is your bedroom. There is a shelf with  a teddy bear on it. 

You can see a kiddie stool, your bed and a dresser here.

mom turnno vacuume timeMom is wanderingmom wandersyourself

>e
Small Hall
You can see a hall closet (closed) here.

mom turnno vacuume timeMom is wanderingmom wanders

>n
Parent's Bedroom
mom turnno vacuume timeMom is wanderingmom wanders

>s
Small Hall
You can see a hall closet (closed) here.

mom turnno vacuume timeMom is wandering
mom wandersMom

* * *

>e
Small Hall
You can see a dog bed (on which is a rubber ball), Chaser and a hall closet (closed) here.

 DEBUG: teddy is in the Your Bedroom

>pour salt on teddy
You can't see any such thing.

* * *

>e
Small Hall
You can see a dog bed (on which is a rubber ball), Chaser and a hall closet (closed) here.

 DEBUG: teddy is in the Your Bedroom

>n
You can't go that way.

DEBUG: dadvision is empty
DEBUG: dad looking for thingsmom is light-policing 
mom is locating salt 

DEBUG: Mom wanders to the Kitchen
DEBUG: Teddy's is deciding
 DEBUG: teddy is in the Your Bedroom

>w
shared bathroom
I share this bathroom with my brother, Bobby.

You can see a dog bed (on which is a rubber ball), Chaser and a mirror here.

DEBUG: dadvision is empty
DEBUG: dad looking for thingsmom is light-policing 
mom is locating salt 

DEBUG: Mom wanders to the Dining Room
DEBUG: Teddy's is deciding
 DEBUG: teddy is in the Your Bedroom

>n
Your Bedroom
This is your bedroom. There is a shelf with a teddy bear on it. 

You can see dad, a widget, your bed and a dresser here.

DEBUG: dadvision is empty
DEBUG: dad looking for thingsmom is light-policing 
mom is locating salt 

DEBUG: Mom wanders to the Kitchen
DEBUG: Teddy's is deciding
 DEBUG: teddy is in the Your Bedroom

>e
Small Hall
You can see a high chair and a hall closet (closed) here.

DEBUG: dadvision is empty
DEBUG: dad looking for thingsDEBUG: Chaser is wandering to the Your Bedroommom is light-policing 
mom is locating salt 

DEBUG: Mom wanders to the Living Room
DEBUG: Teddy's is deciding
 DEBUG: teddy is in the Your Bedroom

>push chair w
Pushing the high chair is difficult and noisy. Time passes.

You push the high chair west to the Your Bedroom.

DEBUG: Teddy heard you
Your Bedroom
This is your bedroom. There is a shelf with a teddy bear on it. 

You can see Chaser, dad, a widget, your bed and a dresser here.

DEBUG: dadvision is empty
DEBUG: dad looking for things
DEBUG:adding high chair to dadvision if absent
DEBUG: the stating position of high chair is the Small Hall
Dad goes east, pushing the high chair away.

DEBUG: Teddy's is deciding
 DEBUG: teddy is in the Your Bedroom

>e
Small Hall
You can see a high chair, dad and a hall closet (closed) here.

DEBUG: dadvision is empty
DEBUG: dad looking for thingsmom is light-policing 
mom is locating salt 

DEBUG: Mom wanders to the Entry Hall
DEBUG: Teddy's is deciding
 DEBUG: teddy is in the Your Bedroom

* * *

>e
Small Hall
You can see a dog bed (on which is a rubber ball), Chaser and a hall closet (closed) here.

 DEBUG: teddy is in the Your Bedroom

>take ball
Taken.

DEBUG: dadvision is empty
DEBUG: dad looking for thingsDEBUG: dad wanders to the Bobby's Bedroom
 DEBUG: teddy is in the Your Bedroom

>throw ball
DEBUG: Teddy heard you
Dropped.

DEBUG: dadvision is empty
DEBUG: dad looking for thingsDEBUG: dad wanders to the Your Bedroom
Chaser puts down the lucky boxers.

Chaser picks up the rubber ball.

mom is light-policing 
mom is locating salt 
DEBUG: Mom wanders to the Your Bedroom
 DEBUG: teddy is in the shared bathroom
Chaser bounds up to you with a rubber ball in his mouth.

Chaser puts down the rubber ball.

He looks up at you expectantly, tail wagging.

>take ball
Taken.

Chaser picks up the lucky boxers.

 DEBUG: teddy is in the shared bathroom

>take boxers
GRRR!
DEBUG: Chaser wanders to the Bobby's Bedroom
Chaser trots up to you, and gives you a friendly lick on the cheek.
mom is light-policing 
mom is locating salt 
DEBUG: Mom wanders to the Your Bedroom 
DEBUG: teddy acts
 DEBUG: teddy is in the shared bathroom

* * *

>push stool east
You push the kiddie stool east to the Small Hall.

Small Hall
You can see a hall closet (closed) here.

turnno vacuume timeMom

>push stool east
You push the kiddie stool east to the Living Room.

Living Room
Mom

>push stool north
You push the kiddie stool north to the Kitchen.

Kitchen
You can see a pantry (closed) here.

Mom

>open pantry
You open the pantry, revealing a salt shaker.

Mom

>take shaker
It is too high for you to reach.

Momactother alonedarkkilledone

>get on stool
You get onto the kiddie stool.

yourself

>take salt
Taken.

yourself

>close pantry
You close the pantry.

yourself

>s
(first getting off the kiddie stool)

Living Room

* * *

>push stool east
You push the kiddie stool east to the Small Hall.

Small Hall
You can see a hall closet (closed) here.

turnno vacuume timeMom

>ACTIONS
Actions listing on.

>push stool south
[pushing the kiddie stool to south]
[(1) going south]
You push the kiddie stool south to the Bobby's Bedroom.

Bobby's Bedroom
You can see a toybox (closed) here.

[(1) going south - succeeded]

[pushing the kiddie stool to south - succeeded]

turnno vacuume time
[Mom going east]
[Mom going east - succeeded]

mom wanders

* * *

>salt floors
yourself and Mom

* * *

>pour salt
(on the salt shaker)
That doesn't need to be salty.

turnno vacuume timeMom is wandering
Mom goes south.

mom wandersyourself

>pour salt on floor
I didn't understand that sentence.

* * *

>pour salt
(on the salt shaker)
That doesn't need to be salty.

turnno vacuume timeMom is wandering
Mom goes south.

mom wandersyourself

>pour salt on ground
You pour the salt on the floor.

turnno vacuume timeMom is wanderingmom wandersTeddy is wanderingMom

>e
Small Hall
You can see Mom and a hall closet (closed) here.

turnno vacuume timeMom is wandering
Mom goes west.

mom wanders

>pour salt on ground
You pour the salt on the floor.

turn

>e
Living Room
turnvaccum timesalted room

>e
Laundry Room
You can see a dryer (closed) and a washer (closed) here.

turnvaccum timesalted room

>pour salt on ground
You pour the salt on the floor.

turnvaccum timesalted room
tryYou hear the whirring of a vacuum cleaner some distance away.

>e
You can't go that way.

turnvaccum timesalted room
tryYou hear the whirring of a vacuum cleaner some distance away.

>l
Laundry Room
You can see a dryer (closed) and a washer (closed) here.

turnvaccum timesalted room
try

>pour salt on ground
You pour the salt on the floor.

turnvaccum timesalted room
Mom arrives from the west.

tryBRRRRRR!
Mom scolds you sternly for spilling salt on her floors, then vacuums up the mess.

* * *

>WAIT
Time passes.

yourself and Momacttwolitnot carried"Click." 
The lights go off.
lightsgoout
It is now pitch dark in here!

>wait
Time passes.

yourself and Mom

>l
Darkness
It is pitch dark, and you can't see a thing.

yourself and Mom

>wait
Time passes.

yourself and Mom

>i
You are carrying:
  a salt shaker

yourself and Momacttwodarknot carried

>i
You are carrying:
  a salt shaker

yourself

>i
You are carrying:
  a salt shaker

yourselfactyou alonedarknot carried

>i
You are carrying:
  Teddy
  a salt shaker

yourselfactyou alonedarkcarried

    *** Teddy got you. ***

Would you like to RESTART, RESTORE a saved game, QUIT or UNDO the last command?

* * *

>examine salt
It is full of salt.

Your pockets suddenly feel lighter.
teddy is in the Your Bedroom

>push stool e
You push the kiddie stool east to the Small Hall.

Small Hall
You can see a hall closet (closed) here.

>push stool e
You push the kiddie stool east to the Living Room.

Living Room
Mom

>push stool north
You push the kiddie stool north to the Kitchen.

Kitchen
You can see a pantry (closed) here.

Mom

>stand on stool
You get onto the kiddie stool.

Mom and yourself

>open pantry
You open the pantry, revealing a salt shaker.

Mom and yourself

>take salt
Taken.

yourself

>pour salt on ground
That doesn't need to be salty.

yourself

>pour salt on floor
That doesn't need to be salty.

yourselfactyou alonelitnot carried

* * *

>examine salt
It is full of salt.

Your pockets suddenly feel lighter.
teddy is in the Your Bedroom

>e
Small Hall
You can see a coin and a hall closet (closed) here.

teddy is in the Your Bedroom

>e
Living Room
teddy is in the Your Bedroom

>e
Laundry Room
You can see a washer (closed) and a dryer (closed) here.

teddy is in the Your Bedroom

>w
Living Room
teddy is in the Your Bedroom

>n
Kitchen
You can see a pantry (closed) here.

teddy is in the Your Bedroom

>open pantry
You open the pantry, revealing a salt shaker.

teddy is in the Your Bedroom

>take salt
It is too high for you to reach.

teddy is in the Your Bedroom

* * *

>examine salt
It is full of salt.

Your pockets suddenly feel lighter.
teddy is in the Your Bedroom

>pour salt on floor
teddy is in the Small Hall

>salt floor
You can't see any such thing.

>salt floors
You can't see any such thing.

>salt the ground
You can't see any such thing.

>pour salt on ground
You can't see any such thing.

>salt ground
You can't see any such thing.

>salt floor
You can't see any such thing.

* * *

>pour salt on floor
teddy is in the Small Hall

>undo
Your Bedroom
[Previous turn undone.]

* * *

>push stool e
Pushing the kiddie stool is difficult and noisy. Time passes.

You push the kiddie stool east to the Small Hall.

increase : 1
turnno vacuume time
mom wanders

>push stool e
You push the kiddie stool east to the Living Room.

Living Room
Bobbyactother alonelitlightsgoout
It is now pitch dark in here!

>push stool n
You push the kiddie stool north to the Kitchen.

Kitchen
You can see a pantry (closed) here.

>open pantry
You open the pantry, revealing a salt shaker.

>get on stool
You get onto the kiddie stool.

yourself

>take salt
Taken.

Mom and yourself

>pour salt on floor
Mom and yourself

>get off stool
You get off the kiddie stool.

Kitchen
You can see a kiddie stool and a pantry (empty) here.

Mom

>pour salt on ground
Mom

* * *

>get on stool
You get onto the kiddie stool.

yourself

>pour salt on ground
You don't have any salt.

yourself

>take salt
Taken.

yourself

>pour salt on ground
yourself

* * *

>push stool e
You push the kiddie stool east to the Living Room.

Living Room
Bobbyactother alonelitlightsgoout
It is now pitch dark in here!

>get on stool
You get onto the kiddie stool.

yourself

>take salt
You can't see any such thing.

>open pantry
You can't see any such thing.

>push stool n
The kiddie stool cannot be pushed from here.

yourself

>push stool w
The kiddie stool cannot be pushed from here.

yourself

>get off stool
You get off the kiddie stool.

Living Room
You can see a kiddie stool here.

>push stool n
You push the kiddie stool north to the Kitchen.

Kitchen
You can see a pantry (closed) here.

yourselfactyou alonelitnot carried

>open pantry
You open the pantry, revealing a salt shaker.

yourself

>get on stool
You get onto the kiddie stool.

yourselfactyou alonelitcarried"Click." 
The lights go off.

It is now pitch dark in here!

>undo
Kitchen
[Previous turn undone.]

>get on stool
You get onto the kiddie stool.

yourself

>take salt
Taken.

yourselfactyou alonelitcarried"Click." 
The lights go off.

It is now pitch dark in here!

>undo
Kitchen
[Previous turn undone.]

>take salt
Taken.

yourselfactyou alonelitcarried"Click." 
The lights go off.

It is now pitch dark in here!

>get off stool
You get off the kiddie stool.

Darkness
It is pitch dark, and you can't see a thing.

yourself

>undo
Darkness
[Previous turn undone.]

>undo
Kitchen
[Previous turn undone.]

>get on stool
But you're already on the kiddie stool.

yourself

>take salt
Taken.

yourself

* * *

>push stool e
You push the kiddie stool east to the Living Room.

Living Room
Bobbyactother alonelitlightsgoout
It is now pitch dark in here!

>push stool
It is fixed in place.

Bobby

>push stool n
You push the kiddie stool north to the Kitchen.

Kitchen
You can see a pantry (closed) here.

Bobby

>get on stool
You get onto the kiddie stool.

Bobby and yourself

>open pantry
You open the pantry, revealing a salt shaker.

Bobby and yourself

>take salt
Taken.

Bobby and yourself

>pour salt on ground
Bobby and yourselfacttwolitnot carried

>i
You are carrying:
  Teddy
  a salt shaker

yourselfactyou alonelitcarried"Click." 
The lights go off.

It is now pitch dark in here!

>pour salt on floor
You can't see any such thing.

>get off stool
You get off the kiddie stool.

Darkness
It is pitch dark, and you can't see a thing.

yourself

>pour salt on floor
You can't see any such thing.

>examine floor
You can't see any such thing.

>examine the floor
You can't see any such thing.

* * *

>push stool e
Pushing the kiddie stool is difficult and noisy. Time passes.

You push the kiddie stool east to the Small Hall.

increase : 1
turnno vacuume time
mom wanders

>push stool south
Time passes as you slowly push the heavy the kiddie stool .

turnno vacuume timeMom

* * *

>push stool e
Pushing the kiddie stool is difficult and noisy. Time passes.

You push the kiddie stool east to the Small Hall.

increase : 1
turnno vacuume time
mom wanders

>drop salt
increase : 1
turnno vacuume timeMom

* * *

>examine floor
You see nothing special about the floor.

Mom goes south.

yourselfactyou alonelitnot carried

>get on stool
You get onto the kiddie stool.

yourself

>examine floor
You see nothing special about the floor.

yourselfactyou alonelitcarried"Click." 
The lights go off.

It is now pitch dark in here!

>get off stool
You get off the kiddie stool.

Darkness
It is pitch dark, and you can't see a thing.

yourself

>push stool e
You push the kiddie stool east to the Small Hall.

Small Hall
You can see a hall closet (closed) here.

Bobby

>push stool e
You push the kiddie stool east to the Living Room.

Living Room
Bobby

>push stool n
You push the kiddie stool north to the Kitchen.

Kitchen
You can see a pantry (closed) here.

Bobby

>open pantry
You open the pantry, revealing a salt shaker.

Bobby

>get on stool
You get onto the kiddie stool.

Bobby and yourselfacttwolitnot carriedlightsgoout
It is now pitch dark in here!

>take salt
You can't see any such thing.

>take salt shaker
You can't see any such thing.

>undo
Darkness
[Previous turn undone.]

* * *

>undo
Kitchen
[Previous turn undone.]

>open pantry
That's already open.

Bobby

>take salt
It is too high for you to reach.

Bobby

>get on stool
You get onto the kiddie stool.

Bobby and yourself

>take salt
Taken.

Bobby and yourselfacttwolitnot carried

>pour salt on ground
yourself

>pour salt on floor
yourself

>get off stool
You get off the kiddie stool.

Kitchen
You can see a kiddie stool and a pantry (empty) here.

yourselfactyou alonelitcarried"Click." 
The lights go off.

It is now pitch dark in here!

>undo
Kitchen
[Previous turn undone.]

>get off stool
You get off the kiddie stool.

Kitchen
You can see a kiddie stool and a pantry (empty) here.

yourself

>examine floor
You see nothing special about the floor.

yourself

>pour salt on floor
yourself

* * *

>pour salt on ground
You pour some salt on the floor.

the Your Bedroom is salted.
Mom sees you pouring salt on the floor.
"My floor! No! You're getting a time-out for this right now!"
Mom drags you to a corner of your bedroom for a 10-minute time-out.

teddy is in the Entry Hall

>wait
Time passes.

teddy is in the Your Bedroom

>wait
Time passes.

mom turnvaccum timesalted roomtry saltpath
Mom arrives from the east.

trydecided to vacuummom is in: the Your Bedroomactother numberlitlightsgooutmom is in: the Your Bedroom

>wait
Time passes.

mom turn

>wait
Time passes.

mom turn

>wait
Time passes.

turn

>wait
Time passes.

Mom

>wait
Time passes.

>wait
Time passes.

Mom arrives from the east.

BRRRRRR!
Mom scolds you sternly for spilling salt on her floors, then vacuums up the mess.
actother numberlitlightsgoout
It is now pitch dark in here!

>wait
Time passes.

Mom goes east.

* * *

>wait
Time passes.

actother numberlitlightsgoout
It is now pitch dark in here!

>get on stool
You get onto the kiddie stool.

yourself

>turn on lights
"Click." 
The lights go on.

yourself

>wait
Time passes.

yourself

>i
You are carrying:
  a salt shaker

yourself

>i
You are carrying:
  a salt shaker

yourself

>i
You are carrying:
  a salt shaker

yourselfactyou alonelitnot carried

>pour salt on ground
You pour the salt on the floor.

yourself

>i
You are carrying:
  Teddy
  a salt shaker

yourself

>i
You are carrying:
  Teddy
  a salt shaker

yourself

>e
(first getting off the kiddie stool)

Small Hall
You can see Mom and a hall closet (closed) here.

yourself and Mom

>wait
Time passes.

yourself and Mom

>open closet
You open the hall closet, revealing a vacuum cleaner.

Mom retrieves the vacuum from the cabinetyourself and Mom

* * *

>wait
Time passes.

Mom arrives from the east.

BRRRRRR!
Mom scolds you sternly for spilling salt on her floors, then vacuums up the mess.
actother numberlitlightsgoout
It is now pitch dark in here!

>get on stool
You get onto the kiddie stool.

Mom: Bobby! Stop playing with the lights!

Exasperated, Mom switches on the lights.
"Click." 
The lights go on.
yourself
My Bedroom (on the kiddie stool)
This is my bedroom. There is a shelf with nothing on it.

You can see Mom, a my bed and a dresser here.

>wait
Time passes.

yourself

* * *

>wait
Time passes.

yourselfactyou alonelitnot carried

>e
(first getting off the kiddie stool)

Small Hall
You can see a hall closet (closed) here.

* * *

>wait
Time passes.

Mom

>e
Small Hall
You can see Mom and a hall closet (closed) here.

>w
My Bedroom
This is my bedroom. There is a shelf with nothing on it.

You can see a kiddie stool, a my bed and a dresser here.

>wait
Time passes.

Mom arrives from the east.

BRRRRRR!
Mom scolds you sternly for spilling salt on her floors, then vacuums up the mess.
actother numberlitwander

>undo
My Bedroom
[Previous turn undone.]

>undo
Small Hall
[Previous turn undone.]

>undo
My Bedroom
[Previous turn undone.]

>wait
Time passes.

Mom

>wait
Time passes.

Mom arrives from the east.

BRRRRRR!
Mom scolds you sternly for spilling salt on her floors, then vacuums up the mess.

>wait
Time passes.

actother numberlitlightsgoout
It is now pitch dark in here!

>wait
Time passes.

Mom: Bobby! Stop playing with the lights!

Exasperated, Mom switches on the lights.
"Click." 
The lights go on.

My Bedroom
This is my bedroom. There is a shelf with nothing on it.

You can see Mom, a kiddie stool, a my bed and a dresser here.

>wait
Time passes.

actother numberlitlightsgoout
It is now pitch dark in here!

>get on stool
You get onto the kiddie stool.

Mom: Bobby! Stop playing with the lights!

Exasperated, Mom switches on the lights.
"Click." 
The lights go on.
yourself
My Bedroom (on the kiddie stool)
This is my bedroom. There is a shelf with nothing on it.

You can see Mom, a my bed and a dresser here.

>turn on lights
The lights are already off.

Mom and yourself

>l
My Bedroom (on the kiddie stool)
This is my bedroom. There is a shelf with  a teddy bear on it. 

You can see Mom, a my bed and a dresser here.

Mom and yourself

>wait
Time passes.

Mom and yourself

>e
(first getting off the kiddie stool)

Small Hall
You can see a hall closet (closed) here.

actother numberlitwander

>open closet
You open the hall closet.

>l
Small Hall
You can see a hall closet (empty) here.

>wait
Time passes.

>l
Small Hall
You can see a hall closet (empty) here.

>e
Living Room

>w
Small Hall
You can see a hall closet (empty) here.

>w
My Bedroom
This is my bedroom. There is a shelf with nothing on it.

You can see Mom, a kiddie stool, a my bed and a dresser here.

>wait
Time passes.

* * *

>wait
Time passes.

mom turn

>e
Small Hall
You can see Mom and a hall closet (closed) here.

turnactother numberlitwanderTeddy is wandering

>wait
Time passes.

turn

>open closet
You open the hall closet, revealing a vacuum cleaner.

turnactother numberlitlightsgoout

* * *

>wait
Time passes.

mom turn

>wiat
That's not a verb I recognise.

>wait
Time passes.

mom turn

>i
You are carrying:
  a salt shaker

turn

* * *

>wait
Time passes.

mom turn

>e
Small Hall
You can see Mom and a hall closet (closed) here.

turn

>wait
Time passes.

turn

>open cabinet
You can't see any such thing.

>open closet
You open the hall closet, revealing a vacuum cleaner.

turn

* * *

>wait
Time passes.

mom turnvaccum timesalted roomtry saltpath
Mom arrives from the east.

trydecided to vacuummom is in: the Your Bedroomactother numberlitlightsgooutmom is in: the Your Bedroom

>e
Small Hall
You can see a hall closet (closed) here.

mom turnvaccum time
Mom arrives from the west.

decided to vacuum

>wait
Time passes.

turnno vacuume timeMom is wandering
Mom goes west.

mom wanders

>w
Your Bedroom
This is your bedroom. There is a shelf with nothing on it.

You can see Mom, a kiddie stool, your bed and a dresser here.

turnno vacuume timeMom is wandering
Mom goes east.

mom wanders

>w
You can't go that way.

turnno vacuume timeMom is wandering
Mom arrives from the east.

mom wanders

>pour salt on ground
You pour the salt on the floor.

turn

>s
Shared Bathroom
I share this bathroom with my brother, Bobby.

You can see a mirror here.

turnvaccum timesalted roomerror- salt path is nothing

* * *

>e
Small Hall
You can see a hall closet (closed) here.

mom turnvaccum time
Mom arrives from the west.

decided to vacuum

>e
Living Room
mom turnno vacuume timeMom is wanderingmom wanders

>pour salt on gorund
You can't see any such thing.

>pour salt on ground
You pour the salt on the floor.

mom turnno vacuume timeMom is wanderingmom wanders

>s
entry hall
You can see Bobby here.

mom turnno vacuume timeMom is wanderingmom wanders

>pour salt on ground
You pour the salt on the floor.

mom turnno vacuume timeMom is wanderingmom wanders

>n
Living Room
mom turnno vacuume timeMom is wandering
mom wanders

>n
Kitchen
You can see a pantry (closed) here.

mom turnno vacuume timeMom is wandering
mom wandersMom

>pour salt on ground
You pour the salt on the floor.

mom turnno vacuume timeMom is wandering
mom wanders

>n
You can't go that way.

mom turnno vacuume timeMom is wandering
mom wanders

>e
Dining Room
You can see a table and a high chair here.

mom turnno vacuume timeMom is wanderingmom wanders

>pour salt on ground
You pour the salt on the floor.

mom turnno vacuume timeMom is wandering
mom wandersactother numberlitwanderTeddy is wandering

>w
Kitchen
You can see a pantry (closed) here.

mom turnno vacuume timeMom is wandering
mom wanders

>pour salt on gorund
You can't see any such thing.

* * *

>pour salt on ground
You pour the salt on the floor.

mom turnno vacuume timeMom is wanderingmom wanders

>w
You can't go that way.

mom turnno vacuume timeMom is wandering
mom wandersMom

>e
Dining Room
You can see a table and a high chair here.

mom turnno vacuume timeMom is wandering
mom wanders

>e
You can't go that way.

mom turnno vacuume timeMom is wandering
mom wandersMom

>s
Laundry Room
You can see a dryer (closed) and a washer (closed) here.

mom turnno vacuume timeMom is wandering
mom wanders

>w
Living Room
mom turnno vacuume timeMom is wanderingmom wanders

>s
entry hall
You can see Bobby here.

mom turnno vacuume timeMom is wanderingmom wanders

>s
You can't go that way.

mom turnno vacuume timeMom is wandering
mom wandersMomactother alonelitlightsgoout

>w
You can't go that way.

mom turnno vacuume timeMom is wandering
mom wanders

>e
You can't go that way.

mom turnno vacuume timeMom is wandering
mom wandersMom

>ACTIONS
Actions listing on.

>WAIT
[waiting]
Time passes.
[waiting - succeeded]

mom turnno vacuume timeMom is wandering
[Mom going east]
[Mom going east - succeeded]

mom wanders

>e
[going east]
You can't go that way.
[going east - failed the can't go that way rule]

mom turnno vacuume timeMom is wanderingmom wanders

>w
[going west]
You can't go that way.
[going west - failed the can't go that way rule]

mom turnno vacuume timeMom is wandering
[Mom going west]
[Mom going west - succeeded]

mom wandersMom

>w
[going west]
You can't go that way.
[going west - failed the can't go that way rule]

mom turnno vacuume timeMom is wandering
[Mom going east]
[Mom going east - succeeded]

mom wanders

>n
[going north]

Living Room
[going north - succeeded]

mom turnno vacuume timeMom is wanderingmom wanders

>n
[going north]

Kitchen
You can see a pantry (closed) here.

[going north - succeeded]

mom turnno vacuume timeMom is wandering
[Mom going west]
[Mom going west - succeeded]

mom wandersMomactother alonelitlightsgoout

>s
[going south]

Living Room
[going south - succeeded]

mom turnno vacuume timeMom is wandering
[Mom going east]
[Mom going east - succeeded]

mom wanders

>s
[going south]

entry hall
You can see Bobby here.

[going south - succeeded]

mom turnno vacuume timeMom is wanderingmom wanders

>n
[going north]

Living Room
[going north - succeeded]

mom turnno vacuume timeMom is wandering
[Mom going west]
[Mom going west - succeeded]

mom wandersMomactother alonelitlightsgoout

>e
[going east]

Laundry Room
You can see a dryer (closed) and a washer (closed) here.

[going east - succeeded]

mom turnno vacuume timeMom is wandering
[Mom going south]
[Mom going south - succeeded]

mom wanders

>s
[going south]

Garage
[going south - succeeded]

mom turnno vacuume timeMom is wandering
[Mom going north]
[Mom going north - succeeded]

mom wandersMom

>w
[going west]
You can't go that way.
[going west - failed the can't go that way rule]

mom turnno vacuume timeMom is wandering
[Mom going south]
[Mom going south - succeeded]

mom wanders

>n
[going north]

Laundry Room
You can see a dryer (closed) and a washer (closed) here.

[going north - succeeded]

mom turnno vacuume timeMom is wandering
[Mom going north]
[Mom going north - succeeded]

mom wandersMom

>n
[going north]

Dining Room
You can see a table and a high chair here.

[going north - succeeded]

mom turnno vacuume timeMom is wandering
[Mom going south]
[Mom going south - succeeded]

mom wanders

>n
[going north]
You can't go that way.
[going north - failed the can't go that way rule]

mom turnno vacuume timeMom is wandering
[Mom going north]
[Mom going north - succeeded]

mom wandersMom

>s
[going south]

Laundry Room
You can see a dryer (closed) and a washer (closed) here.

[going south - succeeded]

mom turnno vacuume timeMom is wandering
[Mom going south]
[Mom going south - succeeded]

mom wanders

>e
[going east]
You can't go that way.
[going east - failed the can't go that way rule]

mom turnno vacuume timeMom is wandering
[Mom going north]
[Mom going north - succeeded]

mom wandersMomactother alonelitlightsgoout

>w
[going west]

Living Room
[going west - succeeded]

mom turnno vacuume timeMom is wandering
[Mom going south]
[Mom going south - succeeded]

mom wanders

>l
[looking]
Living Room
[looking - succeeded]

mom turnno vacuume timeMom is wandering
[Mom going north]
[Mom going north - succeeded]

mom wandersMom

>n
[going north]

Kitchen
You can see a pantry (closed) here.

[going north - succeeded]

mom turnno vacuume timeMom is wandering
[Mom going south]
[Mom going south - succeeded]

mom wandersactother numberlitwanderTeddy is wandering[Teddy going south - silently]
[Teddy going south - silently - succeeded]

>s
[going south]

Living Room
[going south - succeeded]

mom turnno vacuume timeMom is wandering
[Mom going north]
[Mom going north - succeeded]

mom wanders

>s
[going south]

entry hall
You can see Bobby here.

[going south - succeeded]

mom turnno vacuume timeMom is wandering
[Mom going south]
[Mom going south - succeeded]

mom wandersMom

>s
[going south]
You can't go that way.
[going south - failed the can't go that way rule]

mom turnno vacuume timeMom is wandering
[Mom going north]
[Mom going north - succeeded]

mom wandersactother numberlitlightsgoout

I beg your pardon?

>n
[going north]

Living Room
[going north - succeeded]

mom turnno vacuume timeMom is wandering
[Mom going east]
[Mom going east - succeeded]

mom wanders

>w
[going west]

Small Hall
You can see Mom and a hall closet (closed) here.

[going west - succeeded]

mom turnno vacuume timeMom is wanderingmom wanders

>pour salt on ground
[salting the floor]
You pour the salt on the floor.
[salting the floor - succeeded]

mom turnsalted

>wait
[waiting]
Time passes.
[waiting - succeeded]

mom turnvaccum timesalted room
[Mom going west]
mom sees: Your Bedroom and Small Hall
Mom goes west.
[Mom going west - succeeded]

trydecided to vacuum

* * *

>e
Small Hall
You can see a hall closet (closed) here.

mom turnvaccum time
Mom arrives from the west.

decided to vacuum

>pour salt on ground
You pour the salt on the floor.

mom turnsalted

>e
Living Room
mom turnvaccum timesalted roomsalt path is nothing, vacuum time now falsedecided to vacuum

>pour salt on ground
You pour the salt on the floor.

mom turnsaltedactother numberlitlightsgoout

>wait
Time passes.

mom turnvaccum timesalted roomsalt path is nothing, vacuum time now falsedecided to vacuum

* * *

>wait
Time passes.

mom turnvaccum timesalted roomtry saltpath
Mom arrives from the east.

trydecided to vacuummom is in: the Your Bedroomactother numberlitlightsgooutmom is in: the Your Bedroom

>l
Your Bedroom
This is your bedroom. There is a shelf with nothing on it.

You can see Mom, a kiddie stool, your bed and a dresser here.

mom turnvaccum timesalted roomtry saltpathBRRRRRR!
Mom scolds you sternly for spilling salt on her floors, then vacuums up the mess.
decided to vacuummom is in: the Your Bedroommom is in: the Your Bedroom

>wait
Time passes.

mom turnno vacuume timeMom is wandering
Mom goes east.

mom wandersmom is in: the Small HallMomactother alonelitlightsgooutmom is in: the Small Hall

>pour salt on ground
You pour the salt on the floor.

mom turnno vacuume timeMom is wandering
Mom arrives from the east.

mom wandersmom is in: the Your Bedroommom is in: the Your Bedroom

>e
Small Hall
You can see a hall closet (closed) here.

mom turnsaltedmom sees: Your Bedroommom is in: the Your Bedroommom is in: the Your Bedroom

>s
Bobby's Bedroom
You can see a toybox (closed) here.

mom turnvaccum timesalted roomtry saltpathYou hear the whirring of a vacuum cleaner some distance away.
decided to vacuummom is in: the Your Bedroommom is in: the Your Bedroom

>pour salt on ground
You pour the salt on the floor.

mom turnvaccum timesalted roomtry saltpathdecided to vacuummom is in: the Your Bedroommom is in: the Your Bedroom

>n
Small Hall
You can see a hall closet (closed) here.

mom turnvaccum timesalted roomtry saltpathdecided to vacuummom is in: the Your Bedroommom is in: the Your Bedroom

>n
Parent's Bedroom
mom turnvaccum timesalted roomtry saltpathdecided to vacuummom is in: the Your Bedroommom is in: the Your Bedroom

* * *

>wait
Time passes.

teddy is in the Your Bedroom

>l
Your Bedroom
This is your bedroom. There is a shelf with  a teddy bear on it. 

You can see Mom, a kiddie stool, your bed and a dresser here.

mom turnmom notices the salt in the Your Bedroom

>wait
Time passes.

turnactother numberlitlightsgoout

* * *

>l
Your Bedroom
This is your bedroom. There is a shelf with  a teddy bear on it. 

You can see Mom, a kiddie stool, your bed and a dresser here.

mom turnmom notices the salt in the Your Bedroom

>ACTIONS
Actions listing on.

>L
[looking]
Your Bedroom
This is your bedroom. There is a shelf with  a teddy bear on it. 

You can see Mom, a kiddie stool, your bed and a dresser here.

[looking - succeeded]

mom turnmom notices the salt in the Your Bedroom

* * *

>wait
Time passes.

teddy is in the Your Bedroom

>e
Small Hall
You can see Mom and a hall closet (closed) here.

turn

>wait
Time passes.

turnactother numberlitwanderTeddy is wandering

>wait
Time passes.

turnactother numberlitwanderTeddy is wandering

>wait
Time passes.

turnyourself and Mom

* * *

>wait
Time passes.

teddy is in the Your Bedroom

>e
Small Hall
You can see Mom and a hall closet (closed) here.

mom turnvaccum timesalted roomMom retrieves the vacuum from the closet.
decided to vacuumyourself and Mom

>wait
Time passes.

turnBobbyactother alonelitlightsgoout

>wait
Time passes.

turnBobbyactother alonelitlightsgoout

>wait
Time passes.

turnBobby

>wait
Time passes.

turnBobby

* * *

>e
Small Hall
You can see Mom and a hall closet (closed) here.

mom turnvaccum timesalted roomMom retrieves the vacuum from the closet.
decided to vacuumyourself and Mom

>s
Bobby's Bedroom
You can see a toybox (closed) here.

mom turnvaccum timesalted room
tryYou hear the whirring of a vacuum cleaner some distance away.
decided to vacuum

>pour salt on ground
You pour the salt on the floor.

mom turnvaccum timesalted roomsalt path is nothing, vacuum time now falsedecided to vacuum

>wait
Time passes.

mom turnvaccum timedecided to vacuumactother numberlitlightsgoout

>wait
Time passes.

mom turnsalted

>wait
Time passes.

mom turnvaccum timedecided to vacuum

>wait
Time passes.

mom turnsalted

>n
Small Hall
You can see a hall closet (closed) here.

mom turnvaccum timedecided to vacuum

>wait
Time passes.

mom turnsalted

* * *

>wait
Time passes.

mom turnvaccum timedecided to vacuum

>wait
Time passes.

mom turnsaltedactother numberlitwanderTeddy is wandering

>wait
Time passes.

mom turnvaccum timedecided to vacuumyourself

>wait
Time passes.

mom turnsaltedyourself

>ACTIONS
Actions listing on.

>wait
[waiting]
Time passes.
[waiting - succeeded]

mom turnvaccum timedecided to vacuumyourself

>wait
[waiting]
Time passes.
[waiting - succeeded]

mom turnsaltedyourself

>wait
[waiting]
Time passes.
[waiting - succeeded]

mom turnvaccum timedecided to vacuumyourself

>n
[going north]

Parent's Bedroom
[going north - succeeded]

mom turnsaltedactother numberlitwanderTeddy is wandering[Teddy going west - silently]
[Teddy going west - silently - failed]

>s
[going south]

Small Hall
You can see a hall closet (closed) here.

[going south - succeeded]

mom turnvaccum timedecided to vacuum

>w
[going west]

Your Bedroom
This is your bedroom. There is a shelf with nothing on it.

You can see Mom, a kiddie stool, your bed and a dresser here.

[going west - succeeded]

mom turnsalted

>wait
[waiting]
Time passes.
[waiting - succeeded]

mom turnvaccum timedecided to vacuum

* * *

>pour salt on ground
You pour the salt on the floor.

mom turnvaccum timesalted roomsalt path is nothing, vacuum time now falsedecided to vacuum

>n
Small Hall
You can see a hall closet (closed) here.

mom turnno vacuume timeMom is wandering
Mom arrives from the west.

mom wandersMom and yourself

>pour salt on ground
You pour the salt on the floor.

mom turnsaltedmom sees: Your Bedroom and Small HallTeddy is wandering

>n
Parent's Bedroom
mom turnvaccum timesalted room
mom sees: Your Bedroom and Small Hall
trydecided to vacuumMom

>pour salt on ground
You pour the salt on the floor.

mom turnvaccum timesalted roomsalt path is nothing, vacuum time now falsedecided to vacuumMom

>wait
Time passes.

mom turnno vacuume timeMom is wandering
mom wanders

>wait
Time passes.

mom turnno vacuume timeMom is wanderingmom wanders

* * *

>wait
Time passes.

teddy is in the Your Bedroom

>l
Your Bedroom
This is your bedroom. There is a shelf with nothing on it.

You can see Mom, a kiddie stool, your bed and a dresser here.

mom turnsalted

>wait
Time passes.

mom turnvaccum timedecided to vacuum

* * *

>wait
Time passes.

mom turnsalted

>l
Your Bedroom
This is your bedroom. There is a shelf with nothing on it.

You can see Mom, a kiddie stool, your bed and a dresser here.

mom turnvaccum timedecided to vacuum

* * *

>pour salt on ground
You pour some salt on the floor.

the Your Bedroom is salted.
Mom sees you pouring salt on the floor.
"My floor! No! You're getting a time-out for this right now!"
Mom drags you to a corner of your bedroom for a 10-minute time-out.

teddy is in the Entry Hall

>l
My Bedroom
This is my bedroom. There is a shelf with nothing on it.

You can see Mom, a kiddie stool, a my bed and a dresser here.

* * *

>pour salt on ground
You pour some salt on the floor.

the Your Bedroom is salted.
Mom sees you pouring salt on the floor.
"My floor! No! You're getting a time-out for this right now!"
Mom drags you to a corner of your bedroom for a 10-minute time-out.

teddy is in the Entry Hall

>get on stool
You get onto the kiddie stool.

"Click." 
The lights go on.
yourselfactyou alonelitnot carried
My Bedroom (on the kiddie stool)
This is my bedroom. There is a shelf with nothing on it.

You can see Mom, a my bed and a dresser here.

>pour salt on ground
You pour the salt on the floor.

Mom and yourself

>i
You are carrying:
  Teddy
  a salt shaker

Mom goes east.

yourselfactyou alonelitcarried"Click." 
The lights go off.

It is now pitch dark in here!

>drop teddy
Dropped.

yourself

* * *

>wait
Time passes.

yourselfactyou alonedarkcarried

    *** Teddy got you. ***

Would you like to RESTART, RESTORE a saved game, QUIT or UNDO the last command?

>undo
Darkness
[Previous turn undone.]

>turn on lights
"Click." 
The lights go on.

yourself
My Bedroom (on the kiddie stool)
This is my bedroom. There is a shelf with nothing on it.

You can see a my bed and a dresser here.

>drop teddy
Dropped.

Mom and yourself

>wait
Time passes.

Mom and yourself

>wait
Time passes.

Mom and yourselfacttwolitnot carriedlightsgoout
It is now pitch dark in here!

>wait
Time passes.

Mom and yourself

>i
You are carrying:
  a salt shaker

Mom and yourself

>i
You are carrying:
  a salt shaker

Mom and yourselfacttwolitnot carried

>i
You are carrying:
  Teddy
  a salt shaker

yourself

>undo
Darkness
[Previous turn undone.]

* * *

>turn on lights
"Click." 
The lights go on.

yourself
My Bedroom (on the kiddie stool)
This is my bedroom. There is a shelf with nothing on it.

You can see a my bed and a dresser here.

>wait
Time passes.

yourself

>e
(first getting off the kiddie stool)

Small Hall
You can see Mom and a hall closet (closed) here.

>wait
Time passes.

Mom retrieves the vacuum from the cabinet

* * *

>pour salt on ground
You pour some salt on the floor.

the Your Bedroom is salted.
Mom sees you pouring salt on the floor.
"My floor! No! You're getting a time-out for this right now!"
Mom drags you to a corner of your bedroom for a 10-minute time-out.

teddy is in the Entry Hall

>ACTIONS
Actions listing on.

>WAIT
[waiting]
Time passes.
[waiting - succeeded]

[Mom going east]
Mom goes east.
[Mom going east - succeeded]

>WAIT
[waiting]
Time passes.
[waiting - succeeded]

>WAIT
[waiting]
Time passes.
[waiting - succeeded]

>WAIT
[waiting]
Time passes.
[waiting - succeeded]

actother numberlitwander

>WAIT
[waiting]
Time passes.
[waiting - succeeded]

Mom

>WAIT
[waiting]
Time passes.
[waiting - succeeded]

Momactother alonelitlightsgoout

* * *

>pour salt on ground
You pour some salt on the floor.

the Your Bedroom is salted.
Mom sees you pouring salt on the floor.
"My floor! No! You're getting a time-out for this right now!"
Mom drags you to a corner of your bedroom for a 10-minute time-out.

teddy is in the Entry Hall

>s
Shared Bathroom
I share this bathroom with my brother, Bobby.

You can see Mom and a mirror here.

Mom goes north.

teddy is in the Your Bedroom

>pour salt on ground
You pour the salt on the floor.

mom turnmom notices the salt in the Your Bedroom

>n
Your Bedroom
This is your bedroom. There is a shelf with nothing on it.

You can see a kiddie stool, your bed and a dresser here.

mom turnvaccum timesalted roomtry saltpath
Mom arrives from the east.

trydecided to vacuummom is in: the Your Bedroommom is in: the Your Bedroom

>e
Small Hall
You can see a hall closet (closed) here.

mom turnvaccum time
Mom arrives from the west.

decided to vacuummom is in: the Small Hallactother numberlitlightsgooutTeddy is in: the Dining Room

>salt on ground
You can't see any such thing.

>pour salt on ground
You pour the salt on the floor.

mom turnsaltedmom sees: Small Hallmom is in: the Small HallTeddy is in: the Dining Room

>e
Living Room
mom turnvaccum timesalted room
You'll have to say which compass direction to go in.
I didn't understand that instruction.
tryYou hear the whirring of a vacuum cleaner some distance away.
decided to vacuummom is in: the Small HallTeddy is in: the Dining Room

>pour salt on ground
You pour the salt on the floor.

mom turnvaccum timesalted room
You'll have to say which compass direction to go in.
I didn't understand that instruction.
trydecided to vacuummom is in: the Small HallTeddy is in: the Dining Room

>s
entry hall
You can see Bobby here.

mom turnvaccum timesalted room
You'll have to say which compass direction to go in.
I didn't understand that instruction.
trydecided to vacuummom is in: the Small HallTeddy is in: the Dining Room

>pour salt on ground
You pour the salt on the floor.

mom turnvaccum timesalted room
You'll have to say which compass direction to go in.
I didn't understand that instruction.
trydecided to vacuummom is in: the Small HallTeddy is in: the Dining Room

>pour salt on ground
You pour the salt on the floor.

mom turnvaccum timesalted room
You'll have to say which compass direction to go in.
I didn't understand that instruction.
trydecided to vacuummom is in: the Small HallTeddy is in: the Dining Room

>w
You can't go that way.

mom turnvaccum timesalted room
You'll have to say which compass direction to go in.
I didn't understand that instruction.
trydecided to vacuummom is in: the Small HallTeddy is in: the Dining Room

>n
Living Room
mom turnvaccum timesalted room
You'll have to say which compass direction to go in.
I didn't understand that instruction.
trydecided to vacuummom is in: the Small Hallactother numberlitlightsgooutTeddy is in: the Dining Room

>pour salt on ground
You pour the salt on the floor.

mom turnvaccum timesalted room
You'll have to say which compass direction to go in.
I didn't understand that instruction.
trydecided to vacuummom is in: the Small HallTeddy is in: the Dining Room

>ACTIONS
Actions listing on.

>wait
[waiting]
Time passes.
[waiting - succeeded]

mom turnvaccum timesalted room
You'll have to say which compass direction to go in.
I didn't understand that instruction.
trydecided to vacuummom is in: the Small HallTeddy is in: the Dining Room

* * *

>n
Your Bedroom
This is your bedroom. There is a shelf with nothing on it.

You can see a kiddie stool, your bed and a dresser here.

mom turnvaccum timesalted roomtry saltpath
Mom arrives from the east.

trydecided to vacuummom is in: the Your Bedroommom is in: the Your Bedroom

>wait
Time passes.

mom turnvaccum timesalted roomtry saltpathBRRRRRR!
Mom scolds you sternly for spilling salt on her floors, then vacuums up the mess.
decided to vacuummom is in: the Your Bedroommom is in: the Your Bedroom

* * *

>pour salt on ground
You pour the salt on the floor.

mom turnmom notices the salt in the Your Bedroom

>wait
Time passes.

mom turnmom notices the salt in the Your Bedroom

>wait
Time passes.

mom turnvaccum timesalted roomtry saltpathYou hear the whirring of a vacuum cleaner some distance away.
decided to vacuummom is in: the Your Bedroommom is in: the Your Bedroom

>wait
Time passes.

mom turnvaccum timesalted roomtry saltpathdecided to vacuummom is in: the Your Bedroommom is in: the Your Bedroom

* * *

>wait
Time passes.

mom turnmom notices the salt in the Your Bedroom

>ACTIONS
Actions listing on.

>take salt
[taking the salt shaker]
It is too high for you to reach.
[taking the salt shaker - ended without result]

mom turnmom notices the salt in the Your Bedroom

* * *

>pour salt on ground
You pour some salt on the floor.

the Your Bedroom is salted.
Mom sees you pouring salt on the floor.
"My floor! No! You're getting a time-out for this right now!"
Mom drags you to a corner of your bedroom for a 10-minute time-out.

teddy is in the Entry Hall

>e
Small Hall
You can see Mom and a hall closet (closed) here.

mom is light-policing 
mom is locating salt 
mom is fetching the vacuum 

Mom opens the hall closet.

Mom picks up the vacuum cleaner.

mom is vacuum-doing

Mom closes the hall closet.

teddy is in the Small Hall

>pour salt on ground
You pour some salt on the floor
the Small Hall is salted.

mom is light-policing 
mom is locating salt 
mom sees the salt in Your Bedroommom sees the salt in Small Hallmom is vacuum-doing

Mom goes west.

BRRR! You hear the vacuum cleaner
teddy is in the Your Bedroom

>s
Bobby's Bedroom
You can see a toybox (closed) here.

mom turnvaccum timesalted room
mom sees: Your Bedroom and Small Hall
trydecided to vacuummom is in: the Your Bedroommom is in: the Your Bedroom

>pour salt on ground
You pour the salt on the floor.

mom turnvaccum timesalted roomYou hear the whirring of a vacuum cleaner some distance away.
decided to vacuummom is in: the Your Bedroommom is in: the Your Bedroom

>wait
Time passes.

mom turnvaccum timesalted roomdecided to vacuummom is in: the Your Bedroomactother numberlitwanderTeddy is wanderingmom is in: the Your Bedroom

>wait
Time passes.

mom turnvaccum timesalted roomdecided to vacuummom is in: the Your Bedroommom is in: the Your Bedroom

>wait
Time passes.

mom turnvaccum timesalted roomdecided to vacuummom is in: the Your Bedroommom is in: the Your Bedroom

>ACTIONS
Actions listing on.

>WAIT
[waiting]
Time passes.
[waiting - succeeded]

mom turnvaccum timesalted roomdecided to vacuummom is in: the Your Bedroommom is in: the Your Bedroom

>wait
[waiting]
Time passes.
[waiting - succeeded]

mom turnvaccum timesalted roomdecided to vacuummom is in: the Your Bedroommom is in: the Your Bedroom

>wait
[waiting]
Time passes.
[waiting - succeeded]

mom turnvaccum timesalted roomdecided to vacuummom is in: the Your Bedroommom is in: the Your Bedroom

>wait
[waiting]
Time passes.
[waiting - succeeded]

mom turnvaccum timesalted roomdecided to vacuummom is in: the Your Bedroomactother numberlitlightsgooutmom is in: the Your Bedroom

* * *

>wait
Time passes.

mom turnvaccum timesalted roomdecided to vacuummom is in: the Your Bedroommom is in: the Your Bedroom

>e
You can't go that way.

mom turnvaccum timesalted roomdecided to vacuummom is in: the Your Bedroommom is in: the Your Bedroom

>wait
Time passes.

mom turnvaccum timesalted roomdecided to vacuummom is in: the Your Bedroomactother numberlitwanderTeddy is wanderingmom is in: the Your Bedroom

>wait
Time passes.

mom turnvaccum timesalted roomdecided to vacuummom is in: the Your Bedroomactother numberlitwanderTeddy is wanderingmom is in: the Your Bedroom

>w
Shared Bathroom
I share this bathroom with my brother, Bobby.

You can see a mirror here.

mom turnvaccum timesalted roomdecided to vacuummom is in: the Your Bedroommom is in: the Your Bedroom

>n
Your Bedroom
This is your bedroom. There is a shelf with nothing on it.

You can see Mom, a kiddie stool, your bed and a dresser here.

mom turnvaccum timesalted roomdecided to vacuummom is in: the Your Bedroomactother numberlitlightsgooutmom is in: the Your Bedroom

>e
Small Hall
You can see a hall closet (closed) here.

mom turnvaccum timesalted roomdecided to vacuummom is in: the Your Bedroommom is in: the Your Bedroom

>open closet
You open the hall closet.

mom turnvaccum timesalted roomdecided to vacuummom is in: the Your Bedroommom is in: the Your Bedroom

>l
Small Hall
You can see a hall closet (empty) here.

mom turnvaccum timesalted roomdecided to vacuummom is in: the Your Bedroomactother numberlitlightsgooutmom is in: the Your Bedroom

* * *

>pour salt on ground
You pour some salt on the floor
the Small Hall is salted.

mom is light-policing 
mom is locating salt 
mom sees the salt in Your Bedroommom sees the salt in Small Hallmom is vacuum-doing

Mom goes west.

BRRR! You hear the vacuum cleaner
teddy is in the Your Bedroom

>wait
Time passes.

mom is light-policing 
mom is locating salt 

Mom arrives from the west.

BRRR! You hear the vacuum cleaner
teddy is in the Your Bedroom

>wait
Time passes.

mom is light-policing 
mom is locating salt 
mom is returning the vacuum

Mom opens the hall closet.

Mom puts the vacuum cleaner into the hall closet.

Mom closes the hall closet.

teddy is in the Your Bedroom

>wait
Time passes.

mom turnvaccum timesalted roomon the casemom sees: Your Bedroom and Small Hallsalt path is nothingdecided to vacuummom is in: the Your Bedroommom is in: the Your Bedroom

>wait
Time passes.

mom turnvaccum timesalted roomon the casedecided to vacuummom is in: the Your Bedroommom is in: the Your Bedroom

>wait
Time passes.

mom turnvaccum timesalted roomon the casedecided to vacuummom is in: the Your Bedroommom is in: the Your Bedroom

>ACTIONS
Actions listing on.

>wait
[waiting]
Time passes.
[waiting - succeeded]

mom turnvaccum timesalted roomon the casedecided to vacuummom is in: the Your Bedroommom is in: the Your Bedroom

>wait
[waiting]
Time passes.
[waiting - succeeded]

mom turnvaccum timesalted roomon the casedecided to vacuummom is in: the Your Bedroommom is in: the Your Bedroom

* * *

>wait
Time passes.

mom turnvaccum timesalted roomon the casemom sees: Your Bedroom and Small Hallsalt path is nothingdecided to vacuummom is in: the Your Bedroommom is in: the Your Bedroom

>e
Living Room
mom turnvaccum timesalted roomon the casemom sees: Your Bedroom and Small Hallsalt path is nothingdecided to vacuummom is in: the Your Bedroommom is in: the Your Bedroom

>wait
Time passes.

mom turnvaccum timesalted roomon the casemom sees: Your Bedroom and Small Hallsalt path is nothingdecided to vacuummom is in: the Your Bedroommom is in: the Your Bedroom

* * *

>wait
Time passes.

mom is light-policing 
mom is locating salt 
mom is returning the vacuum

Mom opens the hall closet.

Mom puts the vacuum cleaner into the hall closet.

Mom closes the hall closet.

teddy is in the Your Bedroom

>l
Small Hall
You can see a hall closet (closed) here.

mom is light-policing 
mom is locating salt 

Mom arrives from the west.

mom wanders to the Small Hall

teddy is in the Shared Bathroom

>open hall closet
You open the hall closet.

mom is light-policing 
mom is locating salt 
mom wanders to the Small Hall

teddy is in the Shared Bathroom

>look in hall closet
The hall closet is empty.

mom is light-policing 
mom is locating salt 
mom wanders to the Small Hall

teddy is in the Shared Bathroom

* * *

>wait
Time passes.

mom is light-policing 
mom is locating salt 
mom is returning the vacuum

Mom opens the hall closet.

Mom puts the vacuum cleaner into the hall closet.

Mom closes the hall closet.

teddy is in the Your Bedroom

>e
Living Room
mom is light-policing 
mom is locating salt 

teddy is in the Your Bedroom

* * *

>wait
Time passes.

mom is light-policing 
mom is locating salt 

Mom arrives from the west.

BRRR! You hear the vacuum cleaner
teddy is in the Your Bedroom

>ACTIONS
Actions listing on.

>wait
[waiting]
Time passes.
[waiting - succeeded]

mom turn
You'll have to say which compass direction to go in.
I didn't understand that instruction.

* * *

>pour salt on ground
You pour some salt on the floor
the Small Hall is salted.

mom is light-policing 
mom is locating salt 
mom sees the salt in Your Bedroommom sees the salt in Small Hallmom is vacuum-doing

Mom goes west.

BRRR! You hear the vacuum cleaner
teddy is in the Your Bedroom

>w
Your Bedroom
This is your bedroom. There is a shelf with nothing on it.

You can see Mom, a kiddie stool, your bed and a dresser here.

mom turnmom notices the salt in the Your Bedroommom vacuums the saltentry 1 of momvision is gone Small Hall

>wait
Time passes.

mom turn
Mom goes east.

>e
Small Hall
You can see Mom and a hall closet (closed) here.

mom turnmom notices the salt in the Small Hallmom vacuums the saltentry 1 of momvision is gone

* * *

>e
Small Hall
You can see Mom and a hall closet (closed) here.

mom is light-policing 
mom is locating salt 
mom is fetching the vacuum 

Mom opens the hall closet.

Mom picks up the vacuum cleaner.

mom is vacuum-doing

Mom closes the hall closet.

teddy is in the Small Hall

>open closet
You open the hall closet, revealing a vacuum cleaner.

mom turngetting vacuum

* * *

>e
Small Hall
You can see Mom and a hall closet (closed) here.

mom is light-policing 
mom is locating salt 
mom is fetching the vacuum 

Mom opens the hall closet.

Mom picks up the vacuum cleaner.

mom is vacuum-doing

Mom closes the hall closet.

teddy is in the Small Hall

>wait
Time passes.

mom is light-policing 
mom is locating salt 

Mom goes west.

BRRR! You hear the vacuum cleanerteddy is in the Small Hall

>w
Your Bedroom
This is your bedroom. There is a shelf withnothing on it.

You can see Mom, a kiddie stool, your bed and a dresser here.

mom is light-policing 
mom is locating salt 
teddy is in the Small Hall

>e
Small Hall
You can see a hall closet (closed) here.

mom turn

>w
Your Bedroom
This is your bedroom. There is a shelf with nothing on it.

You can see Mom, a kiddie stool, your bed and a dresser here.

mom turn

* * *

>w
Your Bedroom
This is your bedroom. There is a shelf withnothing on it.

You can see Mom, a kiddie stool, your bed and a dresser here.

mom is light-policing 
mom is locating salt 
teddy is in the Small Hall

>wait
Time passes.

mom is light-policing 
mom is locating salt 
teddy is in the Small Hall

* * *

>wait
Time passes.

mom is light-policing 
mom is locating salt 

Mom goes west.

BRRR! You hear the vacuum cleanerteddy is in the Small Hall

>wait
Time passes.

mom is light-policing 
mom is locating salt 
teddy is in the Small Hall

>wait
Time passes.

mom is light-policing 
mom is locating salt 
mom is trying the closet 

Mom opens the hall closet.

Mom picks up the vacuum cleaner.

Mom closes the hall closet.

teddy is in the Small Hall

>wait
Time passes.

mom is light-policing 
mom is locating salt 

Mom goes west.

BRRR! You hear the vacuum cleanerteddy is in the Small Hall

* * *

>wait
Time passes.

mom is light-policing 
mom is locating salt 
teddy is in the Small Hall

>e
Living Room
mom is light-policing 
mom is locating salt 
teddy is in the Small Hall

>wait
Time passes.

mom is light-policing 
mom is locating salt 
teddy is in the Small Hall

>s
entry hall
You can see Bobby here.

mom is light-policing 
mom is locating salt 
teddy is in the Small Hall

* * *

>e
Small Hall
You can see Mom and a hall closet (closed) here.

mom is light-policing 
mom is locating salt 
mom is fetching the vacuum 

Mom opens the hall closet.

Mom picks up the vacuum cleaner.

mom is vacuum-doing

Mom closes the hall closet.

teddy is in the Small Hall

>w
Your Bedroom
This is your bedroom. There is a shelf with a teddy bear on it. 

You can see a kiddie stool, your bed and a dresser here.

mom is light-policing 
mom is locating salt 
teddy is in the Your Bedroom

>e
Small Hall
You can see Mom and a hall closet (closed) here.

Mom goes west.

teddy is in the Your Bedroom

* * *

>w
Your Bedroom
This is your bedroom. There is a shelf with a teddy bear on it. 

You can see a kiddie stool, your bed and a dresser here.

mom is light-policing 
mom is locating salt 
teddy is in the Your Bedroom

>s
Shared Bathroom
I share this bathroom with my brother, Bobby.

You can see Mom and a mirror here.

Mom goes north.

"Click." 
The lights go off.
teddy is in the Shared Bathroom
It is now pitch dark in here!

* * *

>w
Your Bedroom
This is your bedroom. There is a shelf with a teddy bear on it. 

You can see a kiddie stool, your bed and a dresser here.

mom is light-policing 
mom is locating salt 
teddy is in the Your Bedroom

>examine salt
It is two-thirds full of salt. 

mom is light-policing 
mom is locating salt 
teddy is in the Your Bedroom

* * *

>e
Small Hall
You can see Mom and a hall closet (closed) here.

mom is light-policing 
mom is locating salt 
mom is fetching the vacuum 

Mom opens the hall closet.

Mom picks up the vacuum cleaner.

mom is vacuum-doing

Mom closes the hall closet.

teddy is in the Small Hall

>pour alt on ground
You can't see any such thing.

>pour salt on ground
You pour some salt on the floor
the Small Hall is salted.

mom is light-policing 
mom is locating salt 
mom is busy
mom sees the salt in Your Bedroom
mom is trying the closet 

Mom opens the hall closet.

Mom closes the hall closet.

teddy is in the Shared Bathroom

* * *

>pour salt on ground
You pour some salt on the floor.

the Your Bedroom is salted.
Mom sees you pouring salt on the floor.
"My floor! No! You're getting a time-out for this right now!"
Mom drags you to a corner of your bedroom for a 10-minute time-out.

teddy is in the Entry Hall

>examine salt
It is full of salt.

Your pockets suddenly feel lighter.
teddy is in the Shared Bathroom

>pour salt on floor
You pour the salt on the floor.

teddy is in the Small Hall

>examine salt
It is full of salt.

teddy is in the Small Hall

* * *

>pour salt on ground
You pour some salt on the floor.

the Your Bedroom is salted.
Mom sees you pouring salt on the floor.
"My floor! No! You're getting a time-out for this right now!"
Mom drags you to a corner of your bedroom for a 10-minute time-out.

teddy is in the Entry Hall

>examine salt shaker
It is two-thirds full of salt. 

teddy is in the Shared Bathroom

>pour salt on ground
you pour some salt on the floor.

teddy is in the Shared Bathroom

>pour salt on ground
you pour some salt on the floor.

teddy is in the Shared Bathroom

>pour salt on ground
There is nothing in the salt shaker to pour.

teddy is in the Shared Bathroom

>ACTIONS
Actions listing on.

>pour salt on ground
[pouring the salt shaker]
There is nothing in the salt shaker to pour.
[pouring the salt shaker - failed the Check pouring]

teddy is in the Shared Bathroom

* * *

>pour salt on ground
You pour some salt on the floor.

the Your Bedroom is salted.
Mom sees you pouring salt on the floor.
"My floor! No! You're getting a time-out for this right now!"
Mom drags you to a corner of your bedroom for a 10-minute time-out.

teddy is in the Entry Hall

>cry
Tears well up in your eyes as you sob without restraint.
Mom rushes into the room only to scold you for throwing a tantrum during time-out.

teddy is in the Bobby's Bedroom

>l
Your Bedroom
This is your bedroom. There is a shelf with nothing on it.

You can see Mom, a step stool, your bed, a dresser and a hamper (empty) here.

mom is light-policing 
mom is locating salt 
mom sees the salt in Your Bedroom
mom is vacuum-fetching
mom is fetching the vacuum 

Mom goes east.

teddy is in the Bobby's Bedroom

>cry
Tears well up in your eyes as you sob without restraint.
Mom rushes into the room only to scold you for throwing a tantrum during time-out.

mom is light-policing 
mom is locating salt 
mom sees the salt in Your Bedroom
mom is fetching the vacuum 

Mom goes east.

teddy is in the Shared Bathroom

>wait
Time passes.

teddy is in the Shared Bathroom

>wait
Time passes.

teddy is in the Shared Bathroom

>wait
Time passes.

mom is light-policing 
mom is locating salt 
mom is fetching the vacuum 

mom is vacuum-doing

teddy is in the Shared Bathroom

>wait
Time passes.

teddy is in the Shared Bathroom

time out is over

>wait
Time passes.

teddy is in the Shared Bathroom

>s
Shared Bathroom
I share this bathroom with my brother, Bobby.

You can see a mirror here.

teddy is in the Shared Bathroom

>n
Your Bedroom
This is your bedroom. There is a shelf with nothing on it.

You can see a step stool, your bed, a dresser and a hamper (empty) here.

mom is light-policing 
mom is locating salt 

Mom arrives from the east.

BRRR! Mom vacuums the salt off the floor.
teddy is in the Your Bedroom

>i
You are carrying:
  Teddy
  a lucky boxers
  a salt shaker

teddy is in the Your Bedroom

* * *

>push stool
Where would you like to push it?

yourself and Mom

>push stool e
You push the kiddie stool east to the Small Hall.

Small Hall
You can see a hall closet (closed) here.

Mom

* * *

>w
You can't go that way.

mom turnno vacuume timeMom is wandering
Mom goes east.

mom wandersmom is in: the Small HallyourselfTeddy is in: the Your Bedroom

>e
Small Hall
You can see a hall closet (closed) here.

actother numberlitwander

>e
Living Room

>e
Laundry Room
You can see a dryer (closed) and a washer (closed) here.

yourself

>pour salt on ground
You pour the salt on the floor.

* * *

>wait
Time passes.

>w
Living Room
yourself

>w
Small Hall
You can see a hall closet (closed) here.

* * *

>wait
Time passes.

>ACTIONS
Actions listing on.

>WAIt
[waiting]
Time passes.
[waiting - succeeded]

>wait
[waiting]
Time passes.
[waiting - succeeded]

>wait
[waiting]
Time passes.
[waiting - succeeded]

>i
[taking inventory]
You are carrying:
  a salt shaker

[taking inventory - succeeded]

>i
[taking inventory]
You are carrying:
  a salt shaker

[taking inventory - succeeded]

I beg your pardon?

>i
[taking inventory]
You are carrying:
  a salt shaker

[taking inventory - succeeded]

>look
[looking]
My Bedroom
This is my bedroom. There is a shelf with nothing on it.

You can see Mom, a kiddie stool, a my bed and a dresser here.

[looking - succeeded]

actother numberlitlightsgoout

>wait
[waiting]
Time passes.
[waiting - succeeded]

>l
[looking]
My Bedroom
This is my bedroom. There is a shelf with nothing on it.

You can see Mom, a kiddie stool, a my bed and a dresser here.

[looking - succeeded]

* * *

>w
You can't go that way.

mom turnno vacuume timeMom is wandering
Mom goes east.

mom wandersmom is in: the Small HallyourselfTeddy is in: the Your Bedroom

>pour salt on ground
You pour the salt on the floor.

mom turnno vacuume timeMom is wandering
Mom arrives from the east.

mom wandersmom is in: the Your BedroomTeddy is wanderingTeddy is in: the Shared Bathroom

>e
Small Hall
You can see a hall closet (closed) here.

mom turnno vacuume timeMom is wandering
mom wandersMom

>s
Bobby's Bedroom
You can see a toybox (closed) here.

mom turnsaltedMom

>wait
Time passes.

mom turnvaccum timesalted room
mom sees: Your Bedroom
decided to vacuum

>pour salt on ground
You pour the salt on the floor.

mom turnvaccum timesalted roomdecided to vacuumTeddy is wanderingMom

>wait
Time passes.

mom turnvaccum timesalted room
tryYou hear the whirring of a vacuum cleaner some distance away.
decided to vacuum

>n
Small Hall
You can see a hall closet (closed) here.

mom turnvaccum timesalted roomerror- salt path is nothingdecided to vacuumyourself

* * *

>pour salt on ground
You pour the salt on the floor.

mom turnno vacuume timeMom is wandering
Mom arrives from the east.

mom wandersmom is in: the Your BedroomTeddy is wanderingTeddy is in: the Shared Bathroom

>wait
Time passes.

mom turnsaltedmom sees: Your Bedroommom is in: the Your BedroomTeddy is in: the Shared Bathroom

>wait
Time passes.

mom turnvaccum timesalted room
mom sees: Your Bedroom
Mom goes east.

decided to vacuummom is in: the Small Hallactother numberlitlightsgooutTeddy is in: the Shared Bathroom

>e
Small Hall
You can see Mom and a hall closet (closed) here.

mom turnvaccum timesalted roomMom retrieves the vacuum from the closet.
decided to vacuummom is in: the Small Hallactother numberlitlightsgooutTeddy is in: the Parent's Bathroom

>s
Bobby's Bedroom
You can see a toybox (closed) here.

mom turnvaccum timesalted room
tryYou hear the whirring of a vacuum cleaner some distance away.
decided to vacuummom is in: the Your BedroomTeddy is in: the Parent's Bathroom

>pour salt on ground
You pour the salt on the floor.

mom turnvaccum timesalted roommom sees: Your Bedroomsalt path is nothing, vacuum time now falsedecided to vacuummom is in: the Your BedroomTeddy is in: the Parent's Bathroom

>w
Shared Bathroom
I share this bathroom with my brother, Bobby.

You can see a mirror here.

mom turnno vacuume timeMom is wandering
Mom arrives from the north.

mom wandersmom is in: the Shared Bathroomactother numberlitlightsgooutTeddy is in: the Parent's Bathroom

>pour salt on ground
You pour the salt on the floor.

mom turnsaltedmom sees: Your Bedroom and Shared Bathroommom is in: the Shared BathroomTeddy is in: the Parent's Bathroom

>n
Your Bedroom
This is your bedroom. There is a shelf with nothing on it.

You can see a kiddie stool, your bed and a dresser here.

mom turnvaccum timesalted room
mom sees: Your Bedroom and Shared Bathroom
Mom arrives from the south.

trydecided to vacuummom is in: the Your BedroomTeddy is in: the Parent's Bathroom

>pour salt on ground
You pour the salt on the floor.

mom turnvaccum timesalted roommom sees: Your Bedroom and Shared Bathroomsalt path is nothing, vacuum time now falsedecided to vacuummom is in: the Your BedroomTeddy is in: the Parent's Bathroom

* * *

>push supporter e
Time passes as you slowly and noisily push the heavy the kiddie stool.

turnno vacuume time
mom wanders

>ACTIONS
Actions listing on.

>push supporter e
[pushing the kiddie stool to east]
[(1) going east]
Time passes as you slowly and noisily push the heavy the kiddie stool.
[(1) going east - succeeded]

[pushing the kiddie stool to east - succeeded]

turnno vacuume time

* * *

>pushs tool e
That's not a verb I recognise.

>push stool e
The kiddie stool is heavy. Time passes.

You push the kiddie stool east to the Small Hall.

Small Hall
You can see a hall closet (closed) here.

turnno vacuume time
mom wanders

* * *

I beg your pardon?

* * *

>get in stool
You get onto the kiddie stool.

Mom and yourself

>turn off lights
"Click." 
The lights go off.

Mom and yourself
It is now pitch dark in here!

>turn on lights
Mom and yourself
Your Bedroom (on the kiddie stool)
This is your bedroom. There is a shelf with  a teddy bear on it. 

You can see Mom, your bed and a dresser here.

* * *

>examine coin
Fearing discovery, the coin panics!

The coin goes south.

>take coin
You can't see any such thing.

>take imposter
Taken.

yourself and Mom

>examine imposter
There is something odd about this coin, but you can't put your finger on it.

yourself and Mom

>i
You are carrying:
  a coin
  a salt shaker

yourself and Mom

* * *

>examine coin
Fearing discovery, the coin panics!

The coin goes south.

>e
Small Hall
You can see a coin and a hall closet (closed) here.

Mom

>l
Small Hall
You can see a hall closet and a hall closet (closed) here.

Mom

>examine closet
You see nothing special about the hall closet.

Mom

>examine imposter
It looks like a perfectly ordinary hall closet.

Mom

* * *

>examine coin
Fearing discovery, the coin panics!

The coin goes south.

>s
Shared Bathroom
I share this bathroom with my brother, Bobby.

You can see a coin and a mirror here.

Mom

>examine imposter
Imposter? What imposter? There's nothing here but a perfectly ordinary coin.

Mom

>take coin
Fearing discovery, the coin panics!

The coin goes north.

* * *

>i
You are carrying:
  a salt shaker

yourself and Mom

>drop coin
You already have that.

* * *

>i
You are carrying:
  a salt shaker

yourself and Mom

>take mom
I don't suppose Mom would care for that.

yourself and Momacttwolitnot carried

* * *

>examine imposter
It looks like a perfectly ordinary coin.

yourself and Momacttwolitnot carried"Click." 
The lights go off.
lightsgoout
It is now pitch dark in here!

* * *

>examine coin
Test

* * *

>take dresser
That's fixed in place.

yourself and Mom

>i
You are carrying:
  a salt shaker

coin is wandering
The coin goes east.

yourself and Mom

* * *

>e
Small Hall
You can see a hall closet (closed) here.

>wait
Time passes.

Mom

>s
Bobby's Bedroom
You can see a toybox (closed) here.

Mom

>n
Small Hall
You can see a coin and a hall closet (closed) here.

Your pockets suddenly feel lighter.
Mom

>i
You are carrying nothing.

Momactother alonedarkkilledone

>take car
Fearing discovery, the coin panics!

The coin goes west.

>w
Darkness
It is pitch dark, and you can't see a thing.

yourself and coin

>get on stool
You get onto the kiddie stool.

coin and yourself

>turn on lights
coin and yourself
Your Bedroom (on the kiddie stool)
This is your bedroom. There is a shelf with  a teddy bear on it. 

You can see a coin, your bed and a dresser here.

* * *

>e
Small Hall
You can see a hall closet (closed) here.

>take coin
Fearing discovery, the hall closet panics!

The hall closet goes west.

>w
Your Bedroom
This is your bedroom. There is a shelf with  a teddy bear on it. 

You can see a dresser, Mom, a kiddie stool, your bed and a dresser here.

yourself, dresser and Mom

>take dresser
That's fixed in place.

yourself, dresser and Mom

>take other dresser
That's fixed in place.

yourself, dresser and Mom

>take coin
Fearing discovery, the dresser panics!

The dresser goes south.

>s
Shared Bathroom
I share this bathroom with my brother, Bobby.

You can see a mirror and a mirror here.

Your pockets suddenly feel lighter.
Mom

>take mirror
That's fixed in place.

Mom

>take mirror
That's fixed in place.

Mom

>take other mirror
That's fixed in place.

Mom

>take rag
Fearing discovery, the mirror panics!

The mirror goes north.

* * *

>e
Small Hall
You can see a hall closet (closed) here.

>take closet
That's fixed in place.

Mom

>take coin
Fearing discovery, the hall closet panics!

The hall closet goes west.

>w
Your Bedroom
This is your bedroom. There is a shelf with  a teddy bear on it. 

You can see Mom, a kiddie stool, your bed and a dresser here.

yourself and Mom

>n
You can't go that way.

yourself and Mom

>s
Shared Bathroom
I share this bathroom with my brother, Bobby.

You can see a Mom and a mirror here.

Mom

>take mom
Fearing discovery, the Mom panics!

The Mom goes north.

* * *

>e
Small Hall
You can see a hall closet (closed) here.

>s
Bobby's Bedroom
You can see a toybox (closed) here.

>n
Small Hall
You can see a hall closet (closed) here.

>e
Living Room

>w
Small Hall
You can see a hall closet (closed) here.

>s
Bobby's Bedroom
You can see a toybox (closed) here.

* * *

>s
Shared Bathroom
I share this bathroom with my brother, Bobby.

You can see a coin and a mirror here.

>take imposter
Imposter? What imposter? Do you mean the perfectly ordineary coin?

Your pockets suddenly feel lighter.
Mom

>take perfectly ordinary coin
Fearing discovery, the coin panics!

The coin goes north.

>take imposter
You can't see any such thing.

>examine imposter
You can't see any such thing.

>n
Your Bedroom
This is your bedroom. There is a shelf with  a teddy bear on it. 

You can see Mom, a kiddie stool, your bed and a dresser here.

yourself and Mom

>examine imposter
You can't see any such thing.

>e
Small Hall
You can see a dresser and a hall closet (closed) here.

Mom

>examine imposter
Imposter? What imposter? Do you mean the perfectly ordineary dresser?

Mom

>open dresser
Fearing discovery, the dresser panics!

The dresser goes west.

>w
Your Bedroom
This is your bedroom. There is a shelf with  a teddy bear on it. 

You can see Mom, a kiddie stool, your bed and a dresser here.

yourself and Mom

* * *

>s
Shared Bathroom
I share this bathroom with my brother, Bobby.

You can see a coin and a mirror here.

>take coin
Fearing discovery, the coin panics!

The coin goes north.

>l
Shared Bathroom
I share this bathroom with my brother, Bobby.

You can see a mirror here.

Mom

* * *

>take coin
Fearing discovery, the coin panics!

The coin goes north.

>n
Darkness
It is pitch dark, and you can't see a thing.

* * *

>get on stool
You get onto the kiddie stool.

>turn on lights
Your Bedroom (on the kiddie stool)
This is your bedroom. There is a shelf with  a teddy bear on it. 

You can see Mom, your bed and a dresser here.

* * *

>l
teddy is in the Your Bedroom

>s
Shared Bathroom
I share this bathroom with my brother, Bobby.

You can see a mirror here.

mirror and Mom

>e
Bobby's Bedroom
You can see a toybox (closed) here.

mirror and Mom

>n
Small Hall
You can see a hall closet (closed) here.

The Mom arrives from the west.

Mom

>hi mom
That's not a verb I recognise.

>say hello to mom
Fearing discovery, the Mom panics!

* * *

>l
teddy is in the Your Bedroom

>take key
You can't see any such thing.

>take floor
test
teddy is in the Your Bedroom

* * *

>examine all
You can't use multiple objects with that verb.

>take all
Teddy: Taken.
coin: Taken.

yourself and Mom

>ACTIONS
Actions listing on.

>Ttake coin
That's not a verb I recognise.

>take all
There are none at all available!

>drop all
[dropping the coin]
coin: increase : 1[dropping the coin - succeeded]
[dropping Teddy]
Teddy: increase : 2[dropping Teddy - succeeded]
[dropping the salt shaker]
salt shaker: increase : 3[dropping the salt shaker - succeeded]

yourself and Mom

>take coin
You can't see any such thing.

>take the coin
You can't see any such thing.

>take imposter
[taking the coin]
Taken.
[taking the coin - succeeded]

yourself and Mom

>take coin
You can't see any such thing.

* * *

>examine imposter
It looks like a perfectly ordinary coin.

yourself and Mom

>examine coin
Taken.

* * *

>take dresser
That's too heavy to move.

mom is light-policing 
mom is locating salt 

Mom goes east.

teddy is in the Your Bedroom

>i
You are carrying:
  a salt shaker

yourself and Mom

* * *

>take dresser
That's too heavy to move.

mom is light-policing 
mom is locating salt 

Mom goes east.

teddy is in the Your Bedroom

>wait
Time passes.

teddy is in the Your Bedroom

>wait
Time passes.

mom is light-policing 
mom is locating salt 

Mom arrives from the east.

teddy is in the Your Bedroom

* * *

>take high chair
You can't see any such thing.

>ACTIONS
Actions listing on.

>take mirror
You can't see any such thing.

>s
[going south]

Shared Bathroom
I share this bathroom with my brother, Bobby.

You can see a mirror here.

[going south - succeeded]

Mom

>take teddy
You can't see any such thing.

* * *

>take car
Fearing discovery, the coin panics!

The coin goes east.

>take car
You can't see any such thing.

* * *

>take imposter
Imposter? What imposter? Do you mean the perfectly ordinarycoin?

yourself, Mom and coinactother numberlitwander

* * *

>pour salt on carpet
You pour some salt on the floor.

the Your Bedroom is salted.
Mom sees you pouring salt on the floor.
"My carpet! No! You're getting a time-out for this right now!"
Mom drags you to a corner of your bedroom for a 10-minute time-out.

mom is light-policing 
mom is locating salt 
mom sees the salt in Your Bedroom
mom is vacuum-fetching
mom is fetching the vacuum 

Mom goes east.

teddy is in the Small Hall

>l
Your Bedroom
This is your bedroom. There is a shelf with nothing on it.

You can see Mom, a kiddie stool, your bed, a dresser and a coin here.

* * *

>pour salt on carpet
You pour some salt on the floor.

the Your Bedroom is salted.
Mom sees you pouring salt on the floor.
"My carpet! No! You're getting a time-out for this right now!"
Mom drags you to a corner of your bedroom for a 10-minute time-out.

mom is light-policing 
mom is locating salt 
mom sees the salt in Your Bedroom
mom is vacuum-fetching
mom is fetching the vacuum 

Mom goes east.

teddy is in the Small Hall

>s
You cannot leave your room during time-out.

teddy is in the Shared Bathroom

>e
You cannot leave your room during time-out.

teddy is in the Shared Bathroom

>wait
Time passes.

mom is light-policing 
mom is locating salt 
mom is fetching the vacuum 

mom is vacuum-doing

teddy is in the Shared Bathroom

>wait
Time passes.

mom is light-policing 
mom is locating salt 

teddy is in the Shared Bathroom

>wait
Time passes.

mom is light-policing 
mom is locating salt 

teddy is in the Shared Bathroom

* * *

>pour salt on carpet
You pour some salt on the floor.

the Your Bedroom is salted.
Mom sees you pouring salt on the floor.
"My carpet! No! You're getting a time-out for this right now!"
Mom drags you to a corner of your bedroom for a 10-minute time-out.

mom is light-policing 
mom is locating salt 
mom sees the salt in Your Bedroom
mom is vacuum-fetching
mom is fetching the vacuum 

Mom goes east.

teddy is in the Small Hall

>wait
Time passes.

mom is light-policing 
mom is locating salt 
mom is fetching the vacuum 

mom is vacuum-doing

teddy is in the Small Hall

>s
You cannot leave your room during time-out.

teddy is in the Shared Bathroom

>wait
Time passes.

mom is light-policing 
mom is locating salt 

Mom arrives from the east.

BRRR! You hear the vacuum cleanerteddy is in the Shared Bathroom

* * *

>wait
Time passes.

mom is light-policing 
mom is locating salt 
mom is fetching the vacuum 

mom is vacuum-doing

teddy is in the Small Hall

>wait
Time passes.

teddy is in the Small Hall

>wait
Time passes.

teddy is in the Small Hall

>wait
Time passes.

mom is light-policing 
mom is locating salt 

Mom arrives from the east.

BRRR! Mom vacuums the mess.
teddy is in the Small Hall

>s
You cannot leave your room during time-out.

teddy is in the Small Hall

* * *

>pour salt on floor
You pour some salt on the floor.

the Your Bedroom is salted.
Mom sees you pouring salt on the floor.
"My floor! No! You're getting a time-out for this right now!"
Mom drags you to a corner of your bedroom for a 10-minute time-out.

teddy is in the Small Hall

>examine salt
It is two-thirds full of salt. 

Your pockets suddenly feel lighter.
teddy is in the Your Bedroom

* * *

>put on boxers
You put on your lucky boxers. What were you wearing before?
DEBUG: luck= 3

mom is light-policing 
mom is locating salt 

Mom goes south.

teddy is in the Your Bedroom

>take off boxers
DEBUG: luck= 1

mom is light-policing 
mom is locating salt 

Mom arrives from the south.

teddy is in the Your Bedroom

* * *

>pour salt on kiddie stool
You pour some salt on the kiddie stool.

teddy is in the Your Bedroom

>l
Your Bedroom
This is your bedroom. There is a shelf with a teddy bear on it. 

You can see Mom, a kiddie stool, your bed and a dresser here.

teddy is in the Your Bedroom

>pour salt on dresser
You pour some salt on the dresser.

*** Run-time problem P10: Since the dresser is not allowed the property "salted", it is against the rules to try to use it.

teddy is in the Your Bedroom

* * *

>pour salt on stool
You pour some salt on the kiddie stool.

"Click." 
The lights go off.
teddy is in the Your Bedroom
It is now pitch dark in here!

>l
Your Bedroom
This is your bedroom. There is a shelf with a teddy bear on it. 

You can see Mom, an A salty nothing, your bed and a dresser here.

teddy is in the Your Bedroom

* * *

>pour salt on stool
You pour some salt on the kiddie stool.

"Click." 
The lights go off.
teddy is in the Your Bedroom
It is now pitch dark in here!

>undo
Your Bedroom
[Previous turn undone.]

>pour salt on stool
You pour some salt on the kiddie stool.

teddy is in the Your Bedroom

>l
Your Bedroom
This is your bedroom. There is a shelf withnothing on it.

You can see Mom, an A salty nothing, your bed and a dresser here.

teddy is in the Your Bedroom

* * *

>pour salt on dresser
You pour some salt on the dresser.

teddy is in the Your Bedroom

>examine dresser
You see nothing special about the dresser.

teddy is in the Your Bedroom

>l
Your Bedroom
This is your bedroom. There is a shelf with a teddy bear on it. 

You can see Mom, a kiddie stool, your bed and a dresser here.

"Click." 
The lights go off.
teddy is in the Your Bedroom
It is now pitch dark in here!

* * *

>push dresser
That's too heavy to move.

mom is light-policing 
mom is locating salt 

Mom goes south.

teddy is in the Your Bedroom

>s
Shared Bathroom
I share this bathroom with my brother, Bobby.

You can see a mirror here.

mom is light-policing 
mom is locating salt 

Mom arrives from the north.

Teddy is in the Your Bedroom

>ACTIONS
Actions listing on.

>push dresser
You can't see any such thing.

>push mirror
[pushing the mirror]
It is fixed in place.
[pushing the mirror - failed the can't push what's fixed in place rule]

mom is light-policing 
mom is locating salt 

[Mom going north]
Mom goes north.
[Mom going north - succeeded]

Teddy is in the Your Bedroom

* * *

>push dresser
That's too heavy to move.

mom is light-policing 
mom is locating salt 

Mom goes south.

teddy is in the Your Bedroom

>take dresser
That's fixed in place.

mom is light-policing 
mom is locating salt 

Mom arrives from the south.

teddy is in the Your Bedroom

>ACTIONS
Actions listing on.

>TAKE DRESSER
[taking the dresser]
That's fixed in place.
[taking the dresser - failed the can't take what's fixed in place rule]

teddy is in the Your Bedroom

>pull dresser
[pulling the dresser]
It is fixed in place.
[pulling the dresser - failed the can't pull what's fixed in place rule]

mom is light-policing 
mom is locating salt 

[Mom going east]
Mom goes east.
[Mom going east - succeeded]

teddy is in the Your Bedroom

* * *

>examine stool
It's good for reaching high places.

mom is light-policing 
mom is locating salt 

Mom goes east.

teddy is in the Your Bedroom

>take stool
It is too big to carry.

mom is light-policing 
mom is locating salt 

Mom arrives from the east.

teddy is in the Your Bedroom

* * *

>push stool n
Pushing the step stool is difficult and noisy. Time passes.

You push the step stool north to the Your Bedroom.

DEBUG: Teddy heard you
Your Bedroom
This is your bedroom. There is a shelf with a teddy bear on it. 

You can see a dog bed (on which is a rubber ball), dad, a widget, your bed and a dresser here.

DEBUG: Teddy's is deciding
 DEBUG: teddy is in the Your Bedroom

>take stool
It's too heavy to carry, but you may be able to push it somewhere.

mom is light-policing 
mom is locating salt 
teddy is in the Your Bedroom

>examine stool
It's good for reaching high places.

teddy is in the Your Bedroom

* * *

>push stool n
Pushing the step stool is difficult and noisy. Time passes.

You push the step stool north to the Your Bedroom.

DEBUG: Teddy heard you
Your Bedroom
This is your bedroom. There is a shelf with a teddy bear on it. 

You can see a dog bed (on which is a rubber ball), dad, a widget, your bed and a dresser here.

DEBUG: Teddy's is deciding
 DEBUG: teddy is in the Your Bedroom

>examine stool
Good for reaching high places.

DEBUG: Teddy's is deciding 
DEBUG: teddy acts"Click." 
The lights go off.

 DEBUG: teddy is in the Your Bedroom
It is now pitch dark in here!

>take stool
It's too heavy to carry, but you may be able to push it somewhere.

DEBUG: Chaser is wandering to the Bobby's Bedroom
DEBUG: Teddy's is deciding
 DEBUG: teddy is in the Your Bedroom

* * *

>push stool s
Pushing the step stool is difficult and noisy. Time passes.

You push the step stool south to the Shared Bathroom.

Teddy heard you
Shared Bathroom
I share this bathroom with my brother, Bobby.

You can see a mirror here.

teddy is in the Shared Bathroom

>get on stool
You get onto the step stool.

teddy is in the Shared Bathroom

>switch off lights
mom is light-policing 
mom is locating salt 

teddy is in the Shared Bathroom

>turn off lights
The lights are already off.

mom is light-policing 
mom is locating salt 

teddy is in the Shared Bathroom

* * *

>examine dresser
You see nothing special about the dresser.

mom is light-policing 
mom is locating salt 

Mom goes south.

teddy is in the Your Bedroom

>open dresser
It isn't something you can open.

mom is light-policing 
mom is locating salt 

Mom arrives from the south.

teddy is in the Your Bedroom

>open drawers
You open the drawers.

mom is light-policing 
mom is locating salt 

Mom goes south.

teddy is in the Your Bedroom

* * *

>open drawer
You open the drawers.

"Click." 
The lights go off.
teddy is in the Your Bedroom

It is now pitch dark in here!

>close drawers
You close the drawers.

mom is light-policing 
mom is locating salt 

Mom goes east.

teddy is in the Your Bedroom

>examine dresser
A dresser with many drawers.

teddy is in the Your Bedroom

* * *

>get on bed
There's no point.

mom is light-policing 
mom is locating salt 

Mom goes south.

teddy is in the Your Bedroom

>climb on bed
You can't see any such thing.

* * *

>climb on bed
You can't see any such thing.

>climb on your bed
You can't see any such thing.

>get on bed
There's no point.

mom is light-policing 
mom is locating salt 

Mom goes south.

teddy is in the Your Bedroom

* * *

>climb on bed
You can't see any such thing.

>ACTIONS
Actions listing on.

>get on stool
[entering the step stool]
You get onto the step stool.

[entering the step stool - succeeded]

mom is light-policing 
mom is locating salt 

[Mom going south]
Mom goes south.
[Mom going south - succeeded]

teddy is in the Your Bedroom

* * *

>pour salt on hamper
You pour some salt on the hamper
mom is light-policing 
mom is locating salt 

Mom goes south.

teddy is in the Your Bedroom

>l
Your Bedroom
This is your bedroom. There is a shelf with a teddy bear on it. 

You can see a step stool, your bed, a dresser and an A salty nothing (empty) here.

mom is light-policing 
mom is locating salt 

Mom arrives from the south.

teddy is in the Your Bedroom

>get on stool
You get onto the step stool.

mom is light-policing 
mom is locating salt 

Mom goes east.

teddy is in the Your Bedroom

>turn off lights
"Click." 
The lights go off.

mom is light-policing 
mom is locating salt 
teddy is in the Your Bedroom

It is now pitch dark in here!

>i
You are carrying:
  a lucky boxers
  a salt shaker

mom is light-policing 
mom is locating salt 
teddy is in the Your Bedroom

>pour salt on boxers
You pour some salt on the lucky boxers
teddy is in the Your Bedroom

* * *

>pour salt on teddy
You must be carrying Teddy to do that.

teddy is in the Your Bedroom

>take teddy
You already have that.

teddy is in the Your Bedroom

>pour salt on teddy
You pour some salt on Teddy
Teddy shrieks and bites into your arm with a dozen needle-sharp teeth. You drop the bear and the salt shaker, spilling the remainder of its contents. When you look up from your wound, you notice that Teddy is nowhere to be seen.
Teddy heard you
Mom seems to be oblivious to your struggle.

mom is light-policing 
mom is locating salt 
mom sees the salt in Your Bedroom
mom is vacuum-fetching
mom is fetching the vacuum 

Mom goes east.

teddy is in the Your Bedroom

>l
Your Bedroom
This is your bedroom. There is a shelf with nothing on it.

You can see a salt shaker, Mom, a step stool, your bed, a dresser and a hamper (empty) here.

teddy is in the Your Bedroom

>i
You are carrying:
  a salty nothing
  a lucky boxers

mom is light-policing 
mom is locating salt 
mom sees the salt in Your Bedroom
mom is vacuum-fetching
mom is fetching the vacuum 

Mom goes east.

teddy is in the Your Bedroom

* * *

>pour salt on teddy
You pour some salt on Teddy
Teddy shrieks and bites into your arm with a dozen needle-sharp teeth. You drop the bear and the salt shaker, spilling the remainder of its contents. When you look up from your wound, you notice that Teddy is nowhere to be seen.
Teddy heard you
Mom seems to be oblivious to your struggle.

mom is light-policing 
mom is locating salt 
mom sees the salt in Your Bedroom
mom is vacuum-fetching
mom is fetching the vacuum 

Mom goes east.

teddy is in the Your Bedroom

>EXAMINE TEDDY
You see nothing special about Teddy.

mom is light-policing 
mom is locating salt 
mom is fetching the vacuum 

mom is vacuum-doing

teddy is in the Your Bedroom

>i
You are carrying:
  Teddy
  a lucky boxers

teddy is in the Your Bedroom

* * *

>pour salt on teddy
You must be carrying Teddy to do that.

teddy is in the Your Bedroom

>drop teddy
Teddy is already here.

teddy is in the Your Bedroom

>take teddy
Taken.

"Click." 
The lights go off.
teddy is in the Your Bedroom

It is now pitch dark in here!

>pour salt on teddy
You pour some salt on Teddy
Teddy shrieks and bites into your arm with a dozen needle-sharp teeth. You drop the bear and the salt shaker, spilling the remainder of its contents. When you look up from your wound, you notice that Teddy is nowhere to be seen.
DEBUG: Teddy heard you
Mom seems to be oblivious to your struggle.

teddy is in the Your Bedroom

* * *

>pour salt on teddy
You must be carrying Teddy to do that.

teddy is in the Your Bedroom

>pour salt on teddy
You pour some salt on Teddy.

Teddy shrieks and bites into your arm with a dozen needle-sharp teeth. You drop the bear and the salt shaker, spilling the remainder of its contents. When you look up from your wound, you notice that Teddy is nowhere to be seen.
DEBUG: Teddy heard you
Mom seems to be oblivious to your struggle.

teddy is in the Living Room

* * *

>pour salt on Teddy
You pour some salt on Teddy
Teddy shrieks and bites into your arm with a dozen needle-sharp teeth. You drop the bear and the salt shaker, spilling the remainder of its contents. When you look up from your wound, you notice that Teddy is nowhere to be seen.
Mom seems to be oblivious to your struggle
mom is light-policing 
mom is locating salt 
mom sees the salt in Your Bedroom
mom is vacuum-fetching
mom is fetching the vacuum 

Mom goes east.

teddy is in the Shared Bathroom

>examine salt shaker
It is empty.

mom is light-policing 
mom is locating salt 
mom is fetching the vacuum 

mom is vacuum-doing

teddy is in the Shared Bathroom

* * *

>salt teddy
That's not a verb I recognise.

>pour salt on teddy
You pour some salt on Teddy
Teddy shrieks and bites into your arm with a dozen needle-sharp teeth. You drop the bear and the salt shaker, spilling the remainder of its contents. When you look up from your wound, you notice that Teddy is nowhere to be seen.
Teddy heard you
Mom seems to be oblivious to your struggle.

teddy is in the Laundry Room

* * *

>wear boxers
You put on your lucky boxers. What were you wearing before?
DEBUG: luck= 2

teddy is in the Your Bedroom

>take off boxers
DEBUG: luck= 0

teddy is in the Your Bedroom

* * *

>wear lucky boxers
You put on your lucky boxers. What were you wearing before?
DEBUG: luck= 2

"Click." 
The lights go off.
teddy is in the Your Bedroom

It is now pitch dark in here!

>take off lucky boxers
DEBUG: Luck = 0

teddy is in the Your Bedroom

>put on lucky boxers
You put on your lucky boxers. What were you wearing before?
DEBUG: luck= 3

teddy is in the Your Bedroom

>take off boxers
DEBUG: Luck = 0

teddy is in the Your Bedroom

>put on boxers
You put on your lucky boxers. What were you wearing before?
DEBUG: luck= 3

teddy is in the Your Bedroom

* * *

>go west
You can't go that way.

mom is light-policing 
mom is locating salt 

Mom goes south.

teddy is in the Your Bedroom

>go east
Small Hall
You can see a hall closet (closed) here.

teddy is in the Small Hall

I beg your pardon?

>iuj78d778kj
That's not a verb I recognise.

I beg your pardon?

I beg your pardon?

>8u7hettttet6e5te6segs867dygsiyr7y6
That's not a verb I recognise.

>look at hall closet
You see nothing special about the hall closet.

mom is light-policing 
mom is locating salt 

teddy is in the Small Hall

>open hall closet
You open the hall closet, revealing a vacuum cleaner.

teddy is in the Small Hall

* * *

>throw ball east
You can't see any such thing.

>s
Shared Bathroom
I share this bathroom with my brother, Bobby.

You can see Chaser and a mirror here.

The family dog, chaser, bounds up to you with a rubber ball in his mouth.

Chaser puts down the rubber ball.

He looks up at you expectantly, his tail wagging.
mom is light-policing 
mom is locating salt 

teddy is in the Your Bedroom

>throw ball east
I only understood you as far as wanting to throw the rubber ball.

* * *

>throw salt south
mom is light-policing 
mom is locating salt 

Mom goes east.

teddy is in the Your Bedroom

>push salt s
The salt shaker cannot be pushed from place to place.

mom is light-policing 
mom is locating salt 

Mom goes east.

teddy is in the Your Bedroom

>push stool s
Pushing the step stool is difficult and noisy. Time passes.

You push the step stool south to the Shared Bathroom.

DEBUG: Teddy heard you
Shared Bathroom
I share this bathroom with my brother, Bobby.

You can see Chaser and a mirror here.

The family dog, chaser, bounds up to you with a rubber ball in his mouth.

Chaser puts down the rubber ball.

He looks up at you expectantly, his tail wagging.
mom is light-policing 
mom is locating salt 
teddy is in the Shared Bathroom

>ACTIONS
Actions listing on.

>PUSH STOOL N
[pushing the step stool to north]
[(1) going north]
Pushing the step stool is difficult and noisy. Time passes.

You push the step stool north to the Your Bedroom.

[(2) Teddy going north - silently]
[(2) Teddy going north - silently - succeeded]

DEBUG: Teddy heard you
Your Bedroom
This is your bedroom. There is a shelf with a teddy bear on it. 

You can see your bed, a dresser and a hamper (empty) here.

[(1) going north - succeeded]

[pushing the step stool to north - succeeded]

teddy is in the Your Bedroom

* * *

>throw salt south
mom is light-policing 
mom is locating salt 

Mom goes east.

teddy is in the Your Bedroom

>throw salt to shared bathroom
You can't see any such thing.

* * *

>throw salt south
mom is light-policing 
mom is locating salt 

Mom goes east.

teddy is in the Your Bedroom

>s
Shared Bathroom
I share this bathroom with my brother, Bobby.

You can see Chaser and a mirror here.

The family dog, chaser, bounds up to you with a rubber ball in his mouth.

Chaser puts down the rubber ball.

He looks up at you expectantly, his tail wagging.
mom is light-policing 
mom is locating salt 
teddy is in the Your Bedroom

>i
You are carrying:
  your lucky boxers
  a salt shaker

>throw salt north
The family dog, chaser, bounds up to you with a rubber ball in his mouth.

He looks up at you expectantly, his tail wagging.
mom is light-policing 
mom is locating salt 

teddy is in the Your Bedroom

>i
You are carrying:
  your lucky boxers
  a salt shaker

* * *

>push salt south
The salt shaker cannot be pushed from place to place.

teddy is in the Your Bedroom

* * *

>throw salt s
You throw the salt shaker to the south
mom is light-policing 
mom is locating salt 

Mom goes east.

teddy is in the Your Bedroom

>i
You are carrying:
  your lucky boxers

>throw boxers w
DEBUG: Teddy heard you
mom is light-policing 
mom is locating salt 

Mom goes south.

teddy is in the Your Bedroom

>w
You can't go that way.

teddy is in the Your Bedroom

>i
You are carrying nothing.

* * *

>throw salt s
You throw the salt shaker to the south
mom is light-policing 
mom is locating salt 

Mom goes east.

teddy is in the Your Bedroom

>s
Shared Bathroom
I share this bathroom with my brother, Bobby.

You can see a salt shaker, Chaser and a mirror here.

The family dog, chaser, bounds up to you with a rubber ball in his mouth.

He looks up at you expectantly, his tail wagging.
teddy is in the Your Bedroom

I beg your pardon?

>i
You are carrying:
  a salt shaker
  your lucky boxers

* * *

>throw ball n
You can't see any such thing.

>throw salt n
DEBUG: Teddy heard you
the salt shaker bounces harmlessly off the wall.

teddy is in the Your Bedroom

>i
You are carrying:
  your lucky boxers

* * *

>throw salt n
DEBUG: Teddy heard you
the salt shaker bounces harmlessly off the wall.

teddy is in the Your Bedroom

>throw salt s
The salt shaker is already here.

You throw the salt shaker to the south
teddy is in the Your Bedroom

>s
Shared Bathroom
I share this bathroom with my brother, Bobby.

You can see a salt shaker, Chaser and a mirror here.

The family dog, chaser, bounds up to you with a rubber ball in his mouth.

Chaser puts down the rubber ball.

He looks up at you expectantly, his tail wagging.
mom is light-policing 
mom is locating salt 

teddy is in the Your Bedroom

>ACTIONS
Actions listing on.

>THORW SALT N
That's not a verb I recognise.

>throw salt n
[throwing to the salt shaker]
[(1) dropping the salt shaker - silently]
The salt shaker is already here.
[(1) dropping the salt shaker - silently - failed the can't drop what's already dropped rule]

[(1) the salt shaker going north - silently]
[(1) the salt shaker going north - silently - succeeded]

You throw the salt shaker to the north
[throwing to the salt shaker - succeeded]

The family dog, chaser, bounds up to you with a rubber ball in his mouth.

[Chaser dropping the rubber ball]
[Chaser dropping the rubber ball - failed the can't drop what's already dropped rule]

He looks up at you expectantly, his tail wagging.
teddy is in the Your Bedroom

* * *

>throw salt n
The salt shaker slams into the wall and breaks, spilling all of it's contents
teddy is in the Shared Bathroom

* * *

>throw salt shaker s
You throw the salt shaker to the south
mom is light-policing 
mom is locating salt 

Mom goes east.

teddy is in the Your Bedroom

>s
Shared Bathroom
I share this bathroom with my brother, Bobby.

You can see a broken salt shaker, Chaser and a mirror here.

The family dog, chaser, bounds up to you with a rubber ball in his mouth.

He looks up at you expectantly, his tail wagging.
teddy is in the Your Bedroom

>n
Your Bedroom
This is your bedroom. There is a shelf with nothing on it.

You can see a step stool, your bed, a dresser and a hamper (empty) here.

teddy is in the Shared Bathroom

>i
You are carrying:
  a broken salt shaker
  your lucky boxers

* * *

>throw salt shaker n
The salt shaker slams into the wall and breaks, spilling all of it's contents
mom is light-policing 
mom is locating salt 
mom sees the salt in Your Bedroom
mom is vacuum-fetching
mom is fetching the vacuum 

Mom goes east.

teddy is in the Small Hall

>s
Shared Bathroom
I share this bathroom with my brother, Bobby.

You can see Chaser and a mirror here.

The family dog, chaser, bounds up to you with a rubber ball in his mouth.

He looks up at you expectantly, his tail wagging.
mom is light-policing 
mom is locating salt 
mom is fetching the vacuum 

mom is vacuum-doing

teddy is in the Small Hall

>wait
Time passes.

The family dog, chaser, bounds up to you with a rubber ball in his mouth.

He looks up at you expectantly, his tail wagging.
mom is light-policing 
mom is locating salt 

BRRR! You hear the distant sound of the vacuum cleaner.
teddy is in the Small Hall

* * *

>examine boxers
You see nothing special about the lucky boxers.

DEBUG: Teddy's is deciding
 DEBUG: teddy is in the Your Bedroom

* * *

>n
Your Bedroom
This is your bedroom. There is a shelf with a teddy bear on it. 

You can see a hamper (empty), Mom, dad, a widget, your bed and a dresser here.

 DEBUG: teddy is in the Your Bedroom

>drop salt
DEBUG: Teddy heard you
Dropped.

DEBUG: Chaser is wandering to the Bobby's Bedroom
DEBUG: Teddy's is deciding
 DEBUG: teddy is in the Your Bedroom

>s
shared bathroom
I share this bathroom with my brother, Bobby.

You can see a salt shaker, dad, a high chair, Chaser and a mirror here.

DEBUG: dadvision is empty
DEBUG: dad looking for things
DEBUG: Teddy's is deciding
 DEBUG: teddy is in the Your Bedroom

>l
shared bathroom
I share this bathroom with my brother, Bobby.

You can see dad, Chaser and a mirror here.

DEBUG: dadvision is empty
DEBUG: dad looking for things
DEBUG: dad is chasingmom is light-policing 
mom is locating salt 

DEBUG: Mom wanders to the Laundry Room
DEBUG: Teddy's is deciding 
DEBUG: teddy acts
DEBUG: Teddy wanders to the shared bathroom
 DEBUG: teddy is in the shared bathroom

* * *

>s
shared bathroom
I share this bathroom with my brother, Bobby.

You can see a salt shaker, dad, a high chair, Chaser and a mirror here.

DEBUG: dadvision is empty
DEBUG: dad looking for things
DEBUG: Teddy's is deciding
 DEBUG: teddy is in the Your Bedroom

>puch high chair n
That's not a verb I recognise.

>push high chair n
Pushing the high chair is difficult and noisy. Time passes.

You push the high chair north to the Your Bedroom.

DEBUG: Teddy heard you
Your Bedroom
This is your bedroom. There is a shelf with a teddy bear on it. 

You can see a hamper (empty), a widget, your bed and a dresser here.

DEBUG: dadvision is empty
DEBUG: dad looking for things
DEBUG: Teddy's is deciding
 DEBUG: teddy is in the Your Bedroom

* * *

>drop salt
DEBUG: Teddy heard you
Dropped.

DEBUG: Chaser is wandering to the Bobby's Bedroom
DEBUG: Teddy's is deciding
 DEBUG: teddy is in the Your Bedroom

>wait
Time passes.

DEBUG: dad wanders to the Small Hallmom is light-policing 
mom is locating salt 

DEBUG: Mom wanders to the Parent's Bedroom
DEBUG: Teddy's is deciding 
DEBUG: teddy acts
 DEBUG: teddy is in the Your Bedroom

    *** Teddy got you. ***

Would you like to RESTART, RESTORE a saved game, QUIT or UNDO the last command?

>undo
Darkness
[Previous turn undone.]

>wait
Time passes.

DEBUG: dad wanders to the shared bathroom
DEBUG: Teddy's is deciding
 DEBUG: teddy is in the Your Bedroom

>wait
Time passes.

DEBUG: dad wanders to the Bobby's BedroomDEBUG: Chaser is wandering to the Your Bedroommom is light-policing 
mom is locating salt 

DEBUG: Mom wanders to the Parent's Bedroom
DEBUG: Teddy's is deciding
 DEBUG: teddy is in the Your Bedroom

>wait
Time passes.

DEBUG: dad wanders to the Entry Hall
DEBUG: Teddy's is deciding
 DEBUG: teddy is in the Your Bedroom

* * *

>drop salt
DEBUG: Teddy heard you
Dropped.

DEBUG: Chaser is wandering to the Bobby's Bedroom
DEBUG: Teddy's is deciding
 DEBUG: teddy is in the Your Bedroom

>undo
Your Bedroom
[Previous turn undone.]

>undo
shared bathroom
[Previous turn undone.]

>n
Your Bedroom
This is your bedroom. There is a shelf with a teddy bear on it. 

You can see a hamper (empty), dad, a widget, your bed and a dresser here.

DEBUG: Teddy's is deciding
 DEBUG: teddy is in the Your Bedroom

>drop salt
DEBUG: Teddy heard you
Dropped.

DEBUG: Chaser is wandering to the Bobby's Bedroommom is light-policing 
mom is locating salt 

DEBUG: Mom wanders to the Laundry Room
DEBUG: Teddy's is deciding 
DEBUG: teddy acts"Click." 
The lights go off.

 DEBUG: teddy is in the Your Bedroom
It is now pitch dark in here!

>wait
Time passes.

DEBUG: dad wanders to the shared bathroom
DEBUG: Teddy's is deciding 
DEBUG: teddy acts
 DEBUG: teddy is in the Your Bedroom

>undo
Darkness
[Previous turn undone.]

>undo
Your Bedroom
[Previous turn undone.]

>drop salt
DEBUG: Teddy heard you
Dropped.

DEBUG: Teddy's is deciding
 DEBUG: teddy is in the Your Bedroom

>l
Your Bedroom
This is your bedroom. There is a shelf with a teddy bear on it. 

You can see a salt shaker, a widget, your bed and a dresser here.

DEBUG: Chaser is wandering to the Bobby's Bedroom
DEBUG: Teddy's is deciding
 DEBUG: teddy is in the Your Bedroom

* * *

>drop salt
DEBUG: Teddy heard you
Dropped.

DEBUG: Chaser is wandering to the Bobby's Bedroom
DEBUG: Teddy's is deciding
 DEBUG: teddy is in the Your Bedroom

>get on stool
You can't reach into the Garage.

mom is light-policing 
mom is locating salt 

DEBUG: Mom wanders to the Dining Room
DEBUG: Teddy's is deciding
 DEBUG: teddy is in the Your Bedroom

>turn on light
You're too small to reach it.

mom is light-policing 
mom is locating salt 

DEBUG: Mom wanders to the Kitchen
DEBUG: Teddy's is deciding 
DEBUG: teddy acts
 DEBUG: teddy is in the Your Bedroom

* * *

>drop salt
DEBUG: Teddy heard you
Dropped.

DEBUG: Chaser is wandering to the Bobby's Bedroom
DEBUG: Teddy's is deciding
 DEBUG: teddy is in the Your Bedroom

>l
Your Bedroom
This is your bedroom. There is a shelf with a teddy bear on it. 

You can see a salt shaker, dad, a widget, your bed and a dresser here.

DEBUG: Teddy's is deciding
 DEBUG: teddy is in the Your Bedroom

>wait
Time passes.

mom is light-policing 
mom is locating salt 

Mom arrives from the south.

DEBUG: Mom wanders to the Your Bedroom
DEBUG: Teddy's is deciding
 DEBUG: teddy is in the Your Bedroom

>wait
Time passes.

DEBUG: Chaser is wandering to the Your Bedroom
DEBUG: Teddy's is deciding
 DEBUG: teddy is in the Your Bedroom

>wait
Time passes.

DEBUG: Teddy's is deciding
 DEBUG: teddy is in the Your Bedroom

>wait
Time passes.

DEBUG: Teddy's is deciding 
DEBUG: teddy acts"Click." 
The lights go off.

 DEBUG: teddy is in the Your Bedroom
It is now pitch dark in here!

>undo
Your Bedroom
[Previous turn undone.]

>wait
Time passes.

mom is light-policing 
mom is locating salt 

Mom goes south.

DEBUG: Mom wanders to the shared bathroom
DEBUG: Teddy's is deciding
 DEBUG: teddy is in the Your Bedroom

>wait
Time passes.

DEBUG: Teddy's is deciding 
DEBUG: teddy acts
Teddy goes south.

DEBUG: Teddy wanders to the shared bathroom
 DEBUG: teddy is in the shared bathroom

>wait
Time passes.

mom is light-policing 
mom is locating salt 

Mom arrives from the south.

DEBUG: Mom wanders to the Your Bedroom
DEBUG: Teddy's is deciding
 DEBUG: teddy is in the shared bathroom

>l
Your Bedroom
This is your bedroom. There is a shelf with nothing on it.

You can see Mom, Chaser, a salt shaker, dad, a widget, your bed and a dresser here.

DEBUG: Teddy's is deciding
 DEBUG: teddy is in the shared bathroom

>wait
Time passes.

DEBUG: Chaser is wandering to the Your Bedroom
DEBUG: Teddy's is deciding 
DEBUG: teddy acts
 DEBUG: teddy is in the shared bathroom

>wait
Time passes.

DEBUG: dadvision is empty
DEBUG: dad looking for things
DEBUG:adding salt shaker to dadvision if absent
DEBUG: the stating position of salt shaker is the shared bathroom
Dad picks up the salt shaker.

Dad goes south.

DEBUG: dad is chasing to put away salt shaker

DEBUG: Teddy's is deciding
 DEBUG: teddy is in the shared bathroom

* * *

>n
Your Bedroom
This is your bedroom. There is a shelf with a teddy bear on it. 

You can see a hamper (empty), Mom, dad, a widget, your bed and a dresser here.

 DEBUG: teddy is in the Your Bedroom

>s
fail phrase
shared bathroom
I share this bathroom with my brother, Bobby.

You can see dad and a mirror here.

lets clap

DEBUG: Teddy's is deciding
 DEBUG: teddy is in the Your Bedroom

>n
Your Bedroom
This is your bedroom. There is a shelf with a teddy bear on it. 

You can see dad, a hamper (empty), a widget, your bed and a dresser here.

Dad goes south.

DEBUG: dad wanders to the shared bathroom
DEBUG: Teddy's is deciding
 DEBUG: teddy is in the Your Bedroom

>drop salt
DEBUG: Teddy heard you
Dropped.

DEBUG: dad wanders to the Bobby's BedroomDEBUG: Chaser is wandering to the Your Bedroommom is light-policing 
mom is locating salt 

DEBUG: Mom wanders to the Small Hall
DEBUG: Teddy's is deciding
 DEBUG: teddy is in the Your Bedroom

>wait
Time passes.

DEBUG: dad wanders to the Entry Hallmom is light-policing 
mom is locating salt 

DEBUG: Mom wanders to the Parent's Bedroom
DEBUG: Teddy's is deciding 
DEBUG: teddy acts"Click." 
The lights go off.

 DEBUG: teddy is in the Your Bedroom
It is now pitch dark in here!

* * *

>s
fail phrase
shared bathroom
I share this bathroom with my brother, Bobby.

You can see dad and a mirror here.

lets clap

DEBUG: Teddy's is deciding
 DEBUG: teddy is in the Your Bedroom

>s
fail phrase
You can't go that way.

with silver buttons

DEBUG: dadvision is empty
DEBUG: dad looking for things
DEBUG: dad wanders to the Living RoomDEBUG: Chaser is wandering to the Bobby's Bedroom
DEBUG: Teddy's is deciding
 DEBUG: teddy is in the Your Bedroom

* * *

>s
fail phrase
shared bathroom
I share this bathroom with my brother, Bobby.

You can see dad and a mirror here.

lets clap

DEBUG: Teddy's is deciding
 DEBUG: teddy is in the Your Bedroom

>play with bobby
lets clapThat's not a verb I recognise.

* * *

>n
Your Bedroom
This is your bedroom. There is a shelf with a teddy bear on it. 

You can see a hamper (empty), Mom, dad, a widget, your bed and a dresser here.

 DEBUG: teddy is in the Your Bedroom

>undo
shared bathroom
[Previous turn undone.]

>n
Your Bedroom
This is your bedroom. There is a shelf with a teddy bear on it. 

You can see a hamper (empty), dad, a widget, your bed, a dresser and bobby here.

lets clap

DEBUG: Teddy's is deciding 
DEBUG: teddy acts"Click." 
The lights go off.

 DEBUG: teddy is in the Your Bedroom
It is now pitch dark in here!

>drop salt
DEBUG: Teddy heard you
Dropped.

DEBUG: Teddy's is deciding
 DEBUG: teddy is in the Your Bedroom

>l
Your Bedroom
This is your bedroom. There is a shelf with a teddy bear on it. 

You can see a salt shaker, Chaser, a hamper (empty), dad, a widget, your bed and a dresser here.

mom is light-policing 
mom is locating salt 

Mom arrives from the south.

DEBUG: Mom wanders to the Your Bedroom
DEBUG: Teddy's is deciding
 DEBUG: teddy is in the Your Bedroom

>wait
Time passes.

DEBUG: Teddy's is deciding 
DEBUG: teddy acts"Click." 
The lights go off.

 DEBUG: teddy is in the Your Bedroom
It is now pitch dark in here!

* * *

>undo
Your Bedroom
[Previous turn undone.]

>wait
Time passes.

Dad goes east.

DEBUG: dad wanders to the Small Hall
DEBUG: Teddy's is deciding
 DEBUG: teddy is in the Your Bedroom

* * *

>n
Your Bedroom
This is your bedroom. There is a shelf with a teddy bear on it. 

You can see a hamper (empty), dad, a widget, your bed, a dresser and bobby here.

lets clap

DEBUG: Teddy's is deciding 
DEBUG: teddy acts"Click." 
The lights go off.

 DEBUG: teddy is in the Your Bedroom
It is now pitch dark in here!

>all dressed in black, black, black
You seem to want to talk to someone, but I can't see whom.

>undo
Darkness
[Previous turn undone.]

>undo
shared bathroom
[Previous turn undone.]

>n
Your Bedroom
This is your bedroom. There is a shelf with a teddy bear on it. 

You can see a hamper (empty), dad, a widget, your bed, a dresser and bobby here.

lets clap

DEBUG: Teddy's is deciding
 DEBUG: teddy is in the Your Bedroom

>all dressed in black, black, black
You seem to want to talk to someone, but I can't see whom.

>l
fail phrase
Your Bedroom
This is your bedroom. There is a shelf with a teddy bear on it. 

You can see a hamper (empty), dad, a widget, your bed, a dresser and bobby here.

mary mack
mom is light-policing 
mom is locating salt 

DEBUG: Mom wanders to the Living Room
DEBUG: Teddy's is deciding
 DEBUG: teddy is in the Your Bedroom

* * *

>n
Your Bedroom
This is your bedroom. There is a shelf with a teddy bear on it. 

You can see a hamper (empty), Mom, dad, a widget, your bed and a dresser here.

 DEBUG: teddy is in the Your Bedroom

>dorp salt
That's not a verb I recognise.

>drop salt
DEBUG: Teddy heard you
Dropped.

DEBUG: Teddy's is deciding 
DEBUG: teddy acts"Click." 
The lights go off.

 DEBUG: teddy is in the Your Bedroom
It is now pitch dark in here!

>wait
Time passes.

DEBUG: Teddy's is deciding
 DEBUG: teddy is in the Your Bedroom

* * *

>n
Your Bedroom
This is your bedroom. There is a shelf with a teddy bear on it. 

You can see a hamper (empty), Mom, dad, a widget, your bed and a dresser here.

 DEBUG: teddy is in the Your Bedroom

>wait
Bobby gives you an angry look. "No! You have to play with me!"
Bobby looks at you expectantly.
"Play the hand clap game with me!"
mom is light-policing 
mom is locating salt 

DEBUG: Mom wanders to the Garage
DEBUG: Teddy's is deciding
 DEBUG: teddy is in the Your Bedroom

>wait
fail phrase
Time passes.

mary mack

DEBUG: Teddy's is deciding 
DEBUG: teddy acts
Teddy goes east.

DEBUG: Teddy wanders to the Small Hall
 DEBUG: teddy is in the Small Hall

>all dressed in black, black, black
fail phraseYou seem to want to talk to someone, but I can't see whom.

>all dressed in black, black, black
fail phraseYou seem to want to talk to someone, but I can't see whom.

* * *

>wait
Bobby gives you an angry look. "No! You have to play with me!"
Bobby looks at you expectantly.
"Play the hand clap game with me!"
mom is light-policing 
mom is locating salt 

DEBUG: Mom wanders to the Garage
DEBUG: Teddy's is deciding
 DEBUG: teddy is in the Your Bedroom

>play with bobby
"Miss Mary Mack, Mack, Mack...

DEBUG: dadvision is empty
DEBUG: dad looking for things
Dad arrives from the south.

DEBUG: dad wanders to the Your Bedroom
DEBUG: Teddy's is deciding
 DEBUG: teddy is in the Your Bedroom

>play with bobby
You continue the rhyme: "all dressed in black, black, black..."
"with silver buttons, buttons, buttons..."
mom is light-policing 
mom is locating salt 

DEBUG: Mom wanders to the Play Room
DEBUG: Teddy's is deciding
 DEBUG: teddy is in the Your Bedroom

>play with bobby
You continue the rhyme: "all down her back, back back..."
"She asked her mother, mother, mother..."
DEBUG: Chaser is wandering to the Bobby's Bedroom
DEBUG: Teddy's is deciding
 DEBUG: teddy is in the Your Bedroom

>play with bobby
You continue the rhyme: "for fifteen cents, cents, cents..."
"to see the elephant, elephant, elephant..."

DEBUG: dadvision is empty
DEBUG: dad looking for things
Dad goes east.

DEBUG: dad wanders to the Small HallDEBUG: Chaser is wandering to the Bobby's Bedroom
DEBUG: Teddy's is deciding
 DEBUG: teddy is in the Your Bedroom

>play with bobby
You continue the rhyme: "jump over the fence, fence, fence... "
"he jumped so high, high, high..."

DEBUG: Teddy's is deciding
 DEBUG: teddy is in the Your Bedroom

>play with bobby
You continue the rhyme: "he reached the sky, sky, sky..."
"and he didn't come back, back, back..."

DEBUG: dadvision is empty
DEBUG: dad looking for things
DEBUG: dad wanders to the Living Room
DEBUG: Teddy's is deciding
 DEBUG: teddy is in the Your Bedroom

>play with bobby
You continue the rhyme: ""till the fourth of July, -ly, -ly"

mom is light-policing 
mom is locating salt 

DEBUG: Mom wanders to the Entry Hall
DEBUG: Teddy's is deciding
 DEBUG: teddy is in the Your Bedroom

>wait
Bobby gives you an angry look. "No! You have to play with me!"

DEBUG: Chaser is wandering to the Bobby's Bedroom
DEBUG: Teddy's is deciding
 DEBUG: teddy is in the Your Bedroom

* * *

>n
Your Bedroom
This is your bedroom. There is a shelf with a teddy bear on it. 

You can see a hamper (empty), Mom, dad, a widget, your bed and a dresser here.

 DEBUG: teddy is in the Your Bedroom

>i
fail phrase

>l
fail phrase
lets clap
DEBUG: Chaser is wandering to the Bobby's Bedroom
DEBUG: Teddy's is deciding
 DEBUG: teddy is in the Your Bedroom

>play with bobby
That's not a verb I recognise.

* * *

>n
Your Bedroom
This is your bedroom. There is a shelf with a teddy bear on it. 

You can see a hamper (empty), Mom, dad, a widget, your bed and a dresser here.

 DEBUG: teddy is in the Your Bedroom

>play with bobby
"Miss Mary Mack, Mack, Mack..."

DEBUG: Teddy's is deciding 
DEBUG: teddy acts
Teddy goes south.

DEBUG: Teddy wanders to the shared bathroom
 DEBUG: teddy is in the shared bathroom

>l
fail phrase
mary mack

DEBUG: dadvision is empty
DEBUG: dad looking for things
DEBUG: dad wanders to the Bobby's Bedroom
DEBUG: Teddy's is deciding
 DEBUG: teddy is in the Your Bedroom

>play with bobby
with silver buttons

DEBUG: dadvision is empty
DEBUG: dad looking for things
DEBUG: dad wanders to the Entry HallDEBUG: Chaser is wandering to the Bobby's Bedroommom is light-policing 
mom is locating salt 

DEBUG: Mom wanders to the Laundry Room
DEBUG: Teddy's is deciding
 DEBUG: teddy is in the Your Bedroom

* * *

>play with bobby
"Miss Mary Mack, Mack, Mack..."

DEBUG: Teddy's is deciding 
DEBUG: teddy acts
Teddy goes south.

DEBUG: Teddy wanders to the shared bathroom
 DEBUG: teddy is in the shared bathroom

>play with bobby
You continue the rhyme: "all dressed in black, black, black..."
"with silver buttons, buttons, buttons..."

DEBUG: Teddy's is deciding
 DEBUG: teddy is in the Your Bedroom

>play with bobby
You continue the rhyme: "all down her back, back back..."
"She asked her mother, mother, mother..."

DEBUG: Teddy's is deciding
 DEBUG: teddy is in the Your Bedroom

>play with bobby
You continue the rhyme: "for fifteen cents, cents, cents..."
"to see the elephant, elephant, elephant..."

DEBUG: Teddy's is deciding 
DEBUG: teddy acts"Click." 
The lights go off.

 DEBUG: teddy is in the Your Bedroom
It is now pitch dark in here!

>play with boby
You can't see any such thing.

* * *

>n
Your Bedroom
This is your bedroom. There is a shelf with a teddy bear on it. 

You can see a hamper (empty), Mom, dad, a widget, your bed and a dresser here.

 DEBUG: teddy is in the Your Bedroom

>ply with bobby
That's not a verb I recognise.

>play with bobby
"Miss Mary Mack, Mack, Mack..."

DEBUG: Teddy's is deciding
 DEBUG: teddy is in the Your Bedroom

>play with bobby
You: "all dressed in black, black, black..."
"with silver buttons, buttons, buttons..."

DEBUG: Teddy's is deciding
 DEBUG: teddy is in the Your Bedroom

>play with bobby
You: "all down her back, back back..."
"She asked her mother, mother, mother..."

DEBUG: Teddy's is deciding 
DEBUG: teddy acts
Teddy goes east.

DEBUG: Teddy wanders to the Small Hall
 DEBUG: teddy is in the Small Hall

>play with bobby
You: "for fifteen cents, cents, cents..."
"to see the elephant, elephant, elephant..."

DEBUG: Teddy's is deciding
 DEBUG: teddy is in the Small Hall

>play with bobby
You: "jump over the fence, fence, fence... "
"he jumped so high, high, high..."

DEBUG: Teddy's is deciding
 DEBUG: teddy is in the Small Hall

>play with bobby
You: "he reached the sky, sky, sky..."
"and he didn't come back, back, back..."

DEBUG: Teddy's is deciding
 DEBUG: teddy is in the Small Hall

>play with bobby
You continue the rhyme: ""till the fourth of July, -ly, -ly"
Bobby looks at you expectantly.
"Play the hand clap game with me!"

DEBUG: dadvision is empty
DEBUG: dad looking for things
Dad goes east.

DEBUG: dad wanders to the Small Hall
DEBUG: Teddy's is deciding
 DEBUG: teddy is in the Small Hall

* * *

>n
Your Bedroom
This is your bedroom. There is a shelf with a teddy bear on it. 

You can see a hamper (empty), Mom, dad, a widget, your bed and a dresser here.

 DEBUG: teddy is in the Your Bedroom

>l
Your Bedroom
This is your bedroom. There is a shelf with a teddy bear on it. 

You can see dad, a widget, your bed, a dresser and bobby here.

DEBUG: dadvision is empty
DEBUG: dad looking for things
Dad goes east.

DEBUG: dad wanders to the Small Hall
DEBUG: Teddy's is deciding
 DEBUG: teddy is in the Your Bedroom

>l
Your Bedroom
This is your bedroom. There is a shelf with a teddy bear on it. 

You can see a widget, your bed, a dresser and bobby here.

DEBUG: dadvision is empty
DEBUG: dad looking for things
DEBUG: dad wanders to the Parent's Bedroommom is light-policing 
mom is locating salt 

DEBUG: Mom wanders to the Play Room
DEBUG: Teddy's is deciding
 DEBUG: teddy is in the Your Bedroom

>l
Your Bedroom
This is your bedroom. There is a shelf with a teddy bear on it. 

You can see a widget, your bed, a dresser and bobby here.

DEBUG: dadvision is empty
DEBUG: dad looking for things
DEBUG: dad wanders to the Parent's Bathroom
DEBUG: Teddy's is deciding 
DEBUG: teddy acts"Click." 
The lights go off.

 DEBUG: teddy is in the Your Bedroom
It is now pitch dark in here!

>undo
Your Bedroom
[Previous turn undone.]

>l
Your Bedroom
This is your bedroom. There is a shelf with a teddy bear on it. 

You can see a widget, your bed, a dresser and bobby here.

DEBUG: dadvision is empty
DEBUG: dad looking for things
DEBUG: dad wanders to the Small Hall
DEBUG: Teddy's is deciding 
DEBUG: teddy acts"Click." 
The lights go off.

 DEBUG: teddy is in the Your Bedroom
It is now pitch dark in here!

>undo
Your Bedroom
[Previous turn undone.]

>l
Your Bedroom
This is your bedroom. There is a shelf with a teddy bear on it. 

You can see a widget, your bed, a dresser and bobby here.

DEBUG: dadvision is empty
DEBUG: dad looking for things
DEBUG: dad wanders to the Small Hall
DEBUG: Teddy's is deciding
 DEBUG: teddy is in the Your Bedroom

>l
Your Bedroom
This is your bedroom. There is a shelf with a teddy bear on it. 

You can see a widget, your bed, a dresser and bobby here.

DEBUG: dadvision is empty
DEBUG: dad looking for things
DEBUG: dad wanders to the Living Roommom is light-policing 
mom is locating salt 

DEBUG: Mom wanders to the Laundry Room
DEBUG: Teddy's is deciding 
DEBUG: teddy acts"Click." 
The lights go off.

 DEBUG: teddy is in the Your Bedroom
It is now pitch dark in here!

* * *

>n
Your Bedroom
This is your bedroom. There is a shelf with a teddy bear on it. 

You can see a hamper (empty), Mom, dad, a widget, your bed and a dresser here.

 DEBUG: teddy is in the Your Bedroom

>play
(with the salt shaker)
Bobby gives you an angry look. "No! You have to play with me!"
Bobby looks at you expectantly.
"Play the hand clap game with me!"

DEBUG: Teddy's is deciding
 DEBUG: teddy is in the Your Bedroom

>play with bobby
Bobby: "Miss Mary Mack, Mack, Mack..."
mom is light-policing 
mom is locating salt 

DEBUG: Mom wanders to the Bobby's Bedroom
DEBUG: Teddy's is deciding
 DEBUG: teddy is in the Your Bedroom

>play with bobby
You: "all dressed in black, black, black..."
Bobby: "with silver buttons, buttons, buttons..."

DEBUG: dadvision is empty
DEBUG: dad looking for things
Dad arrives from the south.

DEBUG: dad wanders to the Your Bedroom
DEBUG: Teddy's is deciding
 DEBUG: teddy is in the Your Bedroom

>i
Bobby gives you an angry look. "No! You have to play with me!"

>play with bobby
You: "all down her back, back back..."
Bobby: "She asked her mother, mother, mother..."

DEBUG: Teddy's is deciding
 DEBUG: teddy is in the Your Bedroom

* * *

>n
Your Bedroom
This is your bedroom. There is a shelf with a teddy bear on it. 

You can see a hamper (empty), Mom, dad, a widget, your bed and a dresser here.

 DEBUG: teddy is in the Your Bedroom

>drop boxers
You can't see any such thing.

>i
You are carrying:
  a salt shaker

>e
Bobby gives you an angry look. 
 Bobby:"No! You have to play with me!"
Bobby looks at you expectantly.
Bobby:"Play the hand clap game with me!"

 DEBUG: teddy is in the Your Bedroom

>e
Bobby gives you an angry look. 
 Bobby:"No! You have to play with me!"
Bobby looks at you expectantly.
Bobby:"Play the hand clap game with me!"
mom is light-policing 
mom is locating salt 
DEBUG: Mom wanders to the Your Bedroom
 DEBUG: teddy is in the Your Bedroom

>play with bobby
Bobby: "Miss Mary Mack, Mack, Mack..."

DEBUG: dadvision is empty
DEBUG: dad looking for thingsDEBUG: dad wanders to the Bobby's Bedroom
 DEBUG: teddy is in the Your Bedroom

>play with bobby
You: "all dressed in black, black, black..."
Bobby: "with silver buttons, buttons, buttons..."

 DEBUG: teddy is in the Your Bedroom

>play with bobby
You: "all down her back, back, back..."
Bobby: "She asked her mother, mother, mother..."

DEBUG: dadvision is empty
DEBUG: dad looking for thingsDEBUG: dad wanders to the Bobby's BedroomDEBUG: Chaser is wandering to the Bobby's Bedroom
 DEBUG: teddy is in the Your Bedroom

* * *

>n
Your Bedroom
This is your bedroom. There is a shelf with a teddy bear on it. 

You can see a hamper (empty), Mom, dad, a widget, your bed and a dresser here.

 DEBUG: teddy is in the Your Bedroom

>e
Small Hall
You can see a hall closet (closed) here.

mom is light-policing 
mom is locating salt 
DEBUG: Mom wanders to the Bobby's Bedroom
 DEBUG: teddy is in the Your Bedroom

>e
Living Room

DEBUG: dadvision is empty
DEBUG: dad looking for thingsDEBUG: dad wanders to the Your Bedroom
 DEBUG: teddy is in the Your Bedroom

>e
Laundry Room
You can see a hamper (in which is your lucky boxers), a washer (closed) and a dryer (closed) here.

DEBUG: dadvision is empty
DEBUG: dad looking for thingsDEBUG: dad wanders to the Bobby's Bedroom
 DEBUG: teddy is in the Your Bedroom

>take boxers
Taken.

 
DEBUG: teddy actsDEBUG: Teddy wanders to the shared bathroom
 DEBUG: teddy is in the shared bathroom

>examine boxers
They'redirty.

 DEBUG: teddy is in the shared bathroom

>w
Living Room

 DEBUG: teddy is in the shared bathroom

>w
Small Hall
You can see a hall closet (closed) here.

mom is light-policing 
mom is locating salt 
DEBUG: Mom wanders to the Bobby's Bedroom 
DEBUG: teddy acts
 DEBUG: teddy is in the shared bathroom

>w
Darkness
It is pitch dark, and you can't see a thing.

 DEBUG: teddy is in the shared bathroom

>drop boxers
DEBUG: Teddy heard you
Dropped.

mom is light-policing 
mom is locating salt 
DEBUG: Mom wanders to the Bobby's Bedroom
 DEBUG: teddy is in the Your Bedroom

>w
You can't go that way.

DEBUG: dadvision is empty
DEBUG: dad looking for thingsDEBUG: dad wanders to the Your BedroomDEBUG: Chaser is wandering to the Your Bedroom
 DEBUG: teddy is in the Your Bedroom

>wait
Time passes.

DEBUG: Chaser is wandering to the Your Bedroommom is light-policing 
mom is locating salt 
DEBUG: Mom wanders to the Your Bedroom
 DEBUG: teddy is in the Your Bedroom

>wait
Time passes.

 DEBUG: teddy is in the Your Bedroom

>wait
Time passes.

mom is light-policing 
"Who keeps turning off the lights?"
Exasperated, Mom switches on the lights.
"Click." 
The lights go on.
mom is locating salt 
DEBUG: Mom wanders to the Bobby's Bedroom
 DEBUG: teddy is in the Your Bedroom
Your Bedroom
This is your bedroom. There is a shelf with a teddy bear on it. 

You can see Chaser, dad, your lucky boxers, a widget, your bed and a dresser here.

>w
You can't go that way.

mom is light-policing 
mom is locating salt 
DEBUG: Mom wanders to the Bobby's Bedroom
 DEBUG: teddy is in the Your Bedroom

>e
Small Hall
You can see a hall closet (closed) here.

DEBUG: dadvision is empty
DEBUG: dad looking for things*** Couldn't read from entry 1 of a list which is empty ***

*** Run-time problem P50: Attempt to use list item which does not exist.

DEBUG:adding lucky boxers to dadvision if absentDad notices that the lucky boxers is out of place.
"What's this doing here? I'll put it away."
DEBUG: the stating position of lucky boxers is the Laundry Room
Dad arrives from the west.

DEBUG: dad is chasing to put away lucky boxersmom is light-policing 
mom is locating salt 
DEBUG: Mom wanders to the Your Bedroom
 DEBUG: teddy is in the Your Bedroom

>e
Living Room

DEBUG: dadvision is empty
DEBUG: dad looking for things
Dad arrives from the west.

DEBUG: dad is chasing to put away lucky boxersmom is light-policing 
mom is locating salt 
DEBUG: Mom wanders to the Your Bedroom
 DEBUG: teddy is in the Your Bedroom

>e
Laundry Room
You can see a hamper (empty), a washer (closed) and a dryer (closed) here.

DEBUG: dadvision is empty
DEBUG: dad looking for things
Dad arrives from the west.

DEBUG: dad is chasing to put away lucky boxers
(first taking the lucky boxers)
That seems to belong to dad.

mom is light-policing 
mom is locating salt 
DEBUG: Mom wanders to the Bobby's Bedroom
 DEBUG: teddy is in the Your Bedroom

* * *

>n
Your Bedroom
This is your bedroom. There is a shelf with a teddy bear on it. 

You can see a hamper (empty), Mom, dad, a widget, your bed and a dresser here.

 DEBUG: teddy is in the Your Bedroom

>take boxers
Taken.

mom is light-policing 
mom is locating salt 
DEBUG: Mom wanders to the Bobby's Bedroom 
DEBUG: teddy acts"Click." 
The lights go off.

 DEBUG: teddy is in the Your Bedroom
It is now pitch dark in here!

>drop boxers
DEBUG: Teddy heard you
Dropped.

mom is light-policing 
mom is locating salt 
DEBUG: Mom wanders to the Bobby's Bedroom
 DEBUG: teddy is in the Your Bedroom

>take boxers
You can't see any such thing.

>undo
Darkness
[Previous turn undone.]

* * *

>undo
Your Bedroom
[Previous turn undone.]

>take boxers
Taken.

mom is light-policing 
mom is locating salt 
DEBUG: Mom wanders to the Your Bedroom
 DEBUG: teddy is in the Your Bedroom

>e
Small Hall
You can see a hall closet (closed) here.

 DEBUG: teddy is in the Your Bedroom

>e
Living Room
mom is light-policing 
mom is locating salt 
DEBUG: Mom wanders to the Bobby's Bedroom
 DEBUG: teddy is in the Your Bedroom

>n
Kitchen
You can see a pantry (closed) here.

mom is light-policing 
mom is locating salt 
DEBUG: Mom wanders to the Bobby's Bedroom
 DEBUG: teddy is in the Your Bedroom

>w
You can't go that way.

mom is light-policing 
mom is locating salt 
DEBUG: Mom wanders to the Bobby's Bedroom
 DEBUG: teddy is in the Your Bedroom

>s
Living Room
mom is light-policing 
mom is locating salt 
DEBUG: Mom wanders to the Your Bedroom
 DEBUG: teddy is in the Your Bedroom

>w
Small Hall
You can see a hall closet (closed) here.

DEBUG: Chaser is wandering to the Your Bedroom
 DEBUG: teddy is in the Your Bedroom

* * *

>n
Your Bedroom
This is your bedroom. There is a shelf with a teddy bear on it. 

You can see a hamper (empty), Mom, dad, a widget, your bed and a dresser here.

 DEBUG: teddy is in the Your Bedroom

>w
You can't go that way.

 DEBUG: teddy is in the Your Bedroom

>e
Small Hall
You can see a hall closet (closed) here.

 DEBUG: teddy is in the Your Bedroom

* * *

>e
Living Room
mom is light-policing 
mom is locating salt 
DEBUG: Mom wanders to the Bobby's Bedroom
 DEBUG: teddy is in the Your Bedroom

>e
Laundry Room
You can see a washer (closed) and a dryer (closed) here.

 
DEBUG: teddy acts
 DEBUG: teddy is in the Your Bedroom

>open washer
You open the washer, revealing your lucky boxers.

 DEBUG: teddy is in the Your Bedroom

>take boxers
Taken.

mom is light-policing 
mom is locating salt 
DEBUG: Mom wanders to the Your Bedroom
 DEBUG: teddy is in the Your Bedroom

>w
Living Room

DEBUG: dadvision is empty
DEBUG: dad looking for thingsDEBUG: dad wanders to the Your Bedroom
 DEBUG: teddy is in the Your Bedroom

>w
Small Hall
You can see a hall closet (closed) here.

 DEBUG: teddy is in the Your Bedroom

>w
Darkness
It is pitch dark, and you can't see a thing.

DEBUG: dadvision is empty
DEBUG: dad looking for thingsDEBUG: dad wanders to the Bobby's Bedroommom is light-policing 
"Who keeps turning off the lights?"
Exasperated, Mom switches on the lights.
"Click." 
The lights go on.
mom is locating salt 
DEBUG: Mom wanders to the Your Bedroom
 DEBUG: teddy is in the Your Bedroom
Your Bedroom
This is your bedroom. There is a shelf with a teddy bear on it. 

You can see Mom, a hamper (empty), a widget, your bed and a dresser here.

>drop boxers
DEBUG: Teddy heard you
Dropped.

mom is light-policing 
mom is locating salt 
DEBUG: Mom wanders to the Bobby's Bedroom
 DEBUG: teddy is in the Your Bedroom

>wait
Time passes.

DEBUG: dadvision is empty
DEBUG: dad looking for thingsDEBUG: dad wanders to the Bobby's Bedroom
 DEBUG: teddy is in the Your Bedroom

>l
Your Bedroom
This is your bedroom. There is a shelf with a teddy bear on it. 

You can see your lucky boxers, a hamper (empty), a widget, your bed and a dresser here.

DEBUG: dadvision is empty
DEBUG: dad looking for thingsDEBUG: dad wanders to the Your BedroomDEBUG: Chaser is wandering to the Bobby's Bedroom
 DEBUG: teddy is in the Your Bedroom

>e
Small Hall
You can see a hall closet (closed) here.

 DEBUG: teddy is in the Your Bedroom

>w
Your Bedroom
This is your bedroom. There is a shelf with a teddy bear on it. 

You can see dad, your lucky boxers, a hamper (empty), a widget, your bed and a dresser here.

DEBUG: dadvision is empty
DEBUG: dad looking for things*** Couldn't read from entry 1 of a list which is empty ***

*** Run-time problem P50: Attempt to use list item which does not exist.

DEBUG:adding lucky boxers to dadvision if absentDad notices that the lucky boxers is out of place.
"What's this doing here? I'll put it away."
DEBUG: the stating position of lucky boxers is the Laundry Room
Dad picks up the lucky boxers.

Dad goes east.

DEBUG: dad is chasing to put away lucky boxersmom is light-policing 
mom is locating salt 
DEBUG: Mom wanders to the Bobby's Bedroom
 DEBUG: teddy is in the Your Bedroom

>wait
Time passes.

DEBUG: Chaser is wandering to the Bobby's Bedroom 
DEBUG: teddy acts
 DEBUG: teddy is in the Your Bedroom

>wait
Time passes.

 DEBUG: teddy is in the Your Bedroom

>e
Small Hall
You can see dad and a hall closet (closed) here.

 DEBUG: teddy is in the Small Hall

>w
Your Bedroom
This is your bedroom. There is a shelf with nothing on it.

You can see a hamper (empty), a widget, your bed and a dresser here.

DEBUG: dadvision is empty
DEBUG: dad looking for things

DEBUG: dad is chasing to put away lucky boxers
 DEBUG: teddy is in the Your Bedroom

>e
Small Hall
You can see a hall closet (closed) here.

DEBUG: dadvision is empty
DEBUG: dad looking for things

DEBUG: dad is chasing to put away lucky boxers

 DEBUG: teddy is in the Small Hall

>wait
Time passes.

DEBUG: dadvision is empty
DEBUG: dad looking for thingsDEBUG: dad wanders to the Bobby's Bedroommom is light-policing 
mom is locating salt 
DEBUG: Mom wanders to the Your Bedroom
 DEBUG: teddy is in the Small Hall

>s
You can't go that way.

DEBUG: dadvision is empty
DEBUG: dad looking for thingsDEBUG: dad wanders to the Your BedroomDEBUG: Chaser is wandering to the Bobby's Bedroommom is light-policing 
mom is locating salt 
DEBUG: Mom wanders to the Bobby's Bedroom
 DEBUG: teddy is in the Small Hall

>e
Living Room
mom is light-policing 
mom is locating salt 
DEBUG: Mom wanders to the Bobby's Bedroom
 DEBUG: teddy is in the Living Room

>e
Laundry Room
You can see a washer (empty) and a dryer (closed) here.

mom is light-policing 
mom is locating salt 
DEBUG: Mom wanders to the Your Bedroom
 DEBUG: teddy is in the Laundry Room

>open dryer
You open the dryer, revealing your lucky boxers.

mom is light-policing 
mom is locating salt 
DEBUG: Mom wanders to the Your Bedroom
 DEBUG: teddy is in the Laundry Room

>e
You can't go that way.

DEBUG: dadvision is empty
DEBUG: dad looking for thingsDEBUG: dad wanders to the Your Bedroommom is light-policing 
mom is locating salt 
DEBUG: Mom wanders to the Bobby's Bedroom
 DEBUG: teddy is in the Laundry Room

>w
Living Room

 DEBUG: teddy is in the Living Room

>w
Small Hall
You can see a hall closet (closed) here.

DEBUG: dadvision is empty
DEBUG: dad looking for thingsDEBUG: dad wanders to the Your BedroomDEBUG: Chaser is wandering to the Your Bedroommom is light-policing 
mom is locating salt 
DEBUG: Mom wanders to the Your Bedroom
 DEBUG: teddy is in the Small Hall

>w
Your Bedroom
This is your bedroom. There is a shelf with nothing on it.

You can see Mom, Chaser, dad, a hamper (empty), a widget, your bed and a dresser here.

mom is light-policing 
mom is locating salt 
DEBUG: Mom wanders to the Bobby's Bedroom
 DEBUG: teddy is in the Your Bedroom

>drop salt
DEBUG: Teddy heard you
Dropped.

DEBUG: Chaser is wandering to the Your Bedroommom is light-policing 
mom is locating salt 
DEBUG: Mom wanders to the Your Bedroom
 DEBUG: teddy is in the Your Bedroom

* * *

>push chair s
You can't see any such thing.

>push high chair s
You can't see any such thing.

>push stool n
You can't see any such thing.

>n
Your Bedroom
This is your bedroom. There is a shelf with a teddy bear on it. 

You can see a hamper (in which is your lucky boxers), bobby, dad, a widget, your bed and a dresser here.

DEBUG: dadvision is empty
DEBUG: dad looking for things
Dad goes east.

DEBUG: dad wanders to the Small Hall
DEBUG: Teddy's is deciding
 DEBUG: teddy is in the Your Bedroom

>drop salt
DEBUG: Teddy heard you
Dropped.

mom is light-policing 
mom is locating salt 

DEBUG: Mom wanders to the Garage
DEBUG: Teddy's is deciding
 DEBUG: teddy is in the Your Bedroom

>l
Your Bedroom
This is your bedroom. There is a shelf with a teddy bear on it. 

You can see a salt shaker, a hamper (in which is your lucky boxers), bobby, a widget, your bed and a dresser here.

DEBUG: Teddy's is deciding
 DEBUG: teddy is in the Your Bedroom

>wait
Time passes.

DEBUG: Teddy's is deciding 
DEBUG: teddy acts"Click." 
The lights go off.

 DEBUG: teddy is in the Your Bedroom
It is now pitch dark in here!

* * *

>undo
Your Bedroom
[Previous turn undone.]

>drop salt
DEBUG: Teddy heard you
Dropped.

DEBUG: dadvision is empty
DEBUG: dad looking for things
DEBUG: dad wanders to the Living Room
DEBUG: Teddy's is deciding
 DEBUG: teddy is in the Your Bedroom